LblinitTxMaxFeeCell	LblinitTxMaxFeeCell.yaml
LblisProgramCell	LblisProgramCell.yaml
LblisLengthPrefix	LblisLengthPrefix.yaml
LblisOriginCell	LblisOriginCell.yaml
LblinitTxChainIDCell	LblinitTxChainIDCell.yaml
Lblproject'Coln'LegacyProtectedTxData'LParUndsCommUndsCommUndsCommUndsCommUndsCommUndsCommUndsRParUnds'EVM-TYPES'Unds'LegacyTx'Unds'Int'Unds'Int'Unds'Int'Unds'Account'Unds'Int'Unds'Bytes'Unds'Int'Coln'gasPrice	Lblproject'Coln'LegacyProtectedTxData'LParUndsCommUndsCommUndsCommUndsCommUndsCommUndsCommUndsRParUnds'EVM-TYPES'Unds'LegacyTx'Unds'Int'Unds'Int'Unds'Int'Unds'Account'Unds'Int'Unds'Bytes'Unds'Int'Coln'gasPrice.yaml
Lblproject'Coln'LogCellOpt	Lblproject'Coln'LogCellOpt.yaml
Lblproject'Coln'S2KlibZModkontrolZSubcheatcodesZModsrcZModKontrolCheatsContract	Lblproject'Coln'S2KlibZModkontrolZSubcheatcodesZModsrcZModKontrolCheatsContract.yaml
Lblchop'LParUndsRParUnds'WORD'Unds'Int'Unds'Int	Lblchop'LParUndsRParUnds'WORD'Unds'Int'Unds'Int.yaml
Lblproject'Coln'MessageCell	Lblproject'Coln'MessageCell.yaml
Lblproject'Coln'TxType	Lblproject'Coln'TxType.yaml
LblisInterimStatesCell	LblisInterimStatesCell.yaml
Lbl'Hash'computeValidJumpDests'LParUndsRParUnds'EVM'Unds'Set'Unds'Bytes	Lbl'Hash'computeValidJumpDests'LParUndsRParUnds'EVM'Unds'Set'Unds'Bytes.yaml
Lbl'Hash'cleanBranchMapAux'LParUndsCommUndsCommUndsRParUnds'SERIALIZATION'Unds'Map'Unds'Map'Unds'List'Unds'Set	Lbl'Hash'cleanBranchMapAux'LParUndsCommUndsCommUndsRParUnds'SERIALIZATION'Unds'Map'Unds'Map'Unds'List'Unds'Set.yaml
LblisStatusCodeCell	LblisStatusCodeCell.yaml
LblisDepthCell	LblisDepthCell.yaml
Lblproject'Coln'InterimStatesCellOpt	Lblproject'Coln'InterimStatesCellOpt.yaml
LblisCallDataCell	LblisCallDataCell.yaml
Lblproject'Coln'DifficultyCellOpt	Lblproject'Coln'DifficultyCellOpt.yaml
Lblproject'Coln'RefundCellOpt	Lblproject'Coln'RefundCellOpt.yaml
LblinitIsStorageWhitelistActiveCell	LblinitIsStorageWhitelistActiveCell.yaml
Lblproject'Coln'ExpectedOpcodeCellFragment	Lblproject'Coln'ExpectedOpcodeCellFragment.yaml
Lblproject'Coln'LegacyTxData'LParUndsCommUndsCommUndsCommUndsCommUndsCommUndsRParUnds'EVM-TYPES'Unds'LegacyTx'Unds'Int'Unds'Int'Unds'Int'Unds'Account'Unds'Int'Unds'Bytes'Coln'to	Lblproject'Coln'LegacyTxData'LParUndsCommUndsCommUndsCommUndsCommUndsCommUndsRParUnds'EVM-TYPES'Unds'LegacyTx'Unds'Int'Unds'Int'Unds'Int'Unds'Account'Unds'Int'Unds'Bytes'Coln'to.yaml
LblinitStateRootCell	LblinitStateRootCell.yaml
LblinitCheatcodesCell	LblinitCheatcodesCell.yaml
Lblproject'Coln'S2KlibZModkontrolZSubcheatcodesZModsrcZModKontrolCheatsBaseContract	Lblproject'Coln'S2KlibZModkontrolZSubcheatcodesZModsrcZModKontrolCheatsBaseContract.yaml
LblisContract	LblisContract.yaml
LblisGeneratedCounterCell	LblisGeneratedCounterCell.yaml
Lbl'Hash'rlpEncodeTxData'LParUndsRParUnds'SERIALIZATION'Unds'Bytes'Unds'TxData	Lbl'Hash'rlpEncodeTxData'LParUndsRParUnds'SERIALIZATION'Unds'Bytes'Unds'TxData.yaml
LblisCallValueCell	LblisCallValueCell.yaml
Lblproject'Coln'MsgIDCellOpt	Lblproject'Coln'MsgIDCellOpt.yaml
LblinitDepthCell	LblinitDepthCell.yaml
LblAccountCellMap'Coln'in'Unds'keys	LblAccountCellMap'Coln'in'Unds'keys.yaml
LblisLocalMemCellOpt	LblisLocalMemCellOpt.yaml
LblisSet	LblisSet.yaml
LblisMixHashCellOpt	LblisMixHashCellOpt.yaml
Lblproject'Coln'LogCell	Lblproject'Coln'LogCell.yaml
Lblproject'Coln'MixHashCell	Lblproject'Coln'MixHashCell.yaml
Lblproject'Coln'PcCellOpt	Lblproject'Coln'PcCellOpt.yaml
LblCextcodecopy'LParUndsCommUndsRParUnds'GAS-FEES'Unds'Int'Unds'Schedule'Unds'Int	LblCextcodecopy'LParUndsCommUndsRParUnds'GAS-FEES'Unds'Int'Unds'Schedule'Unds'Int.yaml
LblisTxMaxFeeCellOpt	LblisTxMaxFeeCellOpt.yaml
Lblproject'Coln'PrecompiledOp	Lblproject'Coln'PrecompiledOp.yaml
Lblproject'Coln'S2KlibZModforgeZSubstdZModsrcZModStdCheatsContract	Lblproject'Coln'S2KlibZModforgeZSubstdZModsrcZModStdCheatsContract.yaml
LblisNewCallerCell	LblisNewCallerCell.yaml
Lblproject'Coln'Endianness	Lblproject'Coln'Endianness.yaml
LblisTxChainIDCellOpt	LblisTxChainIDCellOpt.yaml
LblisMsgIDCellOpt	LblisMsgIDCellOpt.yaml
Lbl'Unds'-Gas'UndsUnds'GAS-SYNTAX'Unds'Gas'Unds'Gas'Unds'Gas	Lbl'Unds'-Gas'UndsUnds'GAS-SYNTAX'Unds'Gas'Unds'Gas'Unds'Gas.yaml
Lblproject'Coln'OriginCell	Lblproject'Coln'OriginCell.yaml
LblisTimestampCellOpt	LblisTimestampCellOpt.yaml
LblisS2KtestZModCounterTestMethod	LblisS2KtestZModCounterTestMethod.yaml
Lblproject'Coln'InternalOp	Lblproject'Coln'InternalOp.yaml
Lblproject'Coln'OpcodeTypeCell	Lblproject'Coln'OpcodeTypeCell.yaml
LblMerkleMapRLP'LParUndsCommUndsRParUnds'SERIALIZATION'Unds'Bytes'Unds'Map'Unds'Int	LblMerkleMapRLP'LParUndsCommUndsRParUnds'SERIALIZATION'Unds'Bytes'Unds'Map'Unds'Int.yaml
Lbl'Hash'rlpDecode'LParUndsCommUndsRParUnds'SERIALIZATION'Unds'JSON'Unds'Bytes'Unds'LengthPrefix	Lbl'Hash'rlpDecode'LParUndsCommUndsRParUnds'SERIALIZATION'Unds'JSON'Unds'Bytes'Unds'LengthPrefix.yaml
LblG0'LParUndsCommUndsCommUndsCommUndsCommUndsRParUnds'GAS-FEES'Unds'Int'Unds'Schedule'Unds'Bytes'Unds'Int'Unds'Int'Unds'Int	LblG0'LParUndsCommUndsCommUndsCommUndsCommUndsRParUnds'GAS-FEES'Unds'Int'Unds'Schedule'Unds'Bytes'Unds'Int'Unds'Int'Unds'Int.yaml
LblisExpectedRevertCell	LblisExpectedRevertCell.yaml
Lbl'Hash'rlpEncodeWord'LParUndsRParUnds'SERIALIZATION'Unds'Bytes'Unds'Int	Lbl'Hash'rlpEncodeWord'LParUndsRParUnds'SERIALIZATION'Unds'Bytes'Unds'Int.yaml
LblisTransactionsRootCellOpt	LblisTransactionsRootCellOpt.yaml
Lblproject'Coln'FoundryCellFragment	Lblproject'Coln'FoundryCellFragment.yaml
Lblproject'Coln'TransactionsRootCell	Lblproject'Coln'TransactionsRootCell.yaml
Lbl'Hash'sizeWordStack'LParUndsRParUnds'EVM-TYPES'Unds'Int'Unds'WordStack	Lbl'Hash'sizeWordStack'LParUndsRParUnds'EVM-TYPES'Unds'Int'Unds'WordStack.yaml
Lbl'Hash'adjustedExpLength'LParUndsRParUnds'GAS-FEES'Unds'Int'Unds'Int	Lbl'Hash'adjustedExpLength'LParUndsRParUnds'GAS-FEES'Unds'Int'Unds'Int.yaml
LblisS2KlibZModforgeZSubstdZModlibZModdsZSubtestZModsrcZModDSTestMethod	LblisS2KlibZModforgeZSubstdZModlibZModdsZSubtestZModsrcZModDSTestMethod.yaml
Lblproject'Coln'ExpectedEventAddressCellOpt	Lblproject'Coln'ExpectedEventAddressCellOpt.yaml
LblisCallStateCellOpt	LblisCallStateCellOpt.yaml
LblinitRecordEventCell	LblinitRecordEventCell.yaml
Lbl'Hash'parseWord'LParUndsRParUnds'SERIALIZATION'Unds'Int'Unds'String	Lbl'Hash'parseWord'LParUndsRParUnds'SERIALIZATION'Unds'Int'Unds'String.yaml
Lbl'Hash'bloomFilter'LParUndsCommUndsRParUnds'EVM'Unds'Bytes'Unds'List'Unds'Int	Lbl'Hash'bloomFilter'LParUndsCommUndsRParUnds'EVM'Unds'Bytes'Unds'List'Unds'Int.yaml
Lbl'Hash'hashTxData'LParUndsRParUnds'SERIALIZATION'Unds'String'Unds'TxData	Lbl'Hash'hashTxData'LParUndsRParUnds'SERIALIZATION'Unds'String'Unds'TxData.yaml
Lblproject'Coln'ExpectedValueCellOpt	Lblproject'Coln'ExpectedValueCellOpt.yaml
LblMessageCellMapItem	LblMessageCellMapItem.yaml
LblisExpectedDepthCellOpt	LblisExpectedDepthCellOpt.yaml
Lbl'Hash'merkleExtensionBuilder'LParUndsCommUndsCommUndsCommUndsCommUndsRParUnds'SERIALIZATION'Unds'MerkleTree'Unds'Bytes'Unds'Bytes'Unds'String'Unds'Bytes'Unds'String	Lbl'Hash'merkleExtensionBuilder'LParUndsCommUndsCommUndsCommUndsCommUndsRParUnds'SERIALIZATION'Unds'MerkleTree'Unds'Bytes'Unds'Bytes'Unds'String'Unds'Bytes'Unds'String.yaml
LblisNewCallerCellOpt	LblisNewCallerCellOpt.yaml
Lblproject'Coln'TimestampCell	Lblproject'Coln'TimestampCell.yaml
Lblproject'Coln'S2KlibZModforgeZSubstdZModsrcZModconsole2Contract	Lblproject'Coln'S2KlibZModforgeZSubstdZModsrcZModconsole2Contract.yaml
Lblproject'Coln'S2KlibZModforgeZSubstdZModsrcZModstdErrorMethod	Lblproject'Coln'S2KlibZModforgeZSubstdZModsrcZModstdErrorMethod.yaml
Lbl'UndsStar'Word'UndsUnds'EVM-TYPES'Unds'Int'Unds'Int'Unds'Int	Lbl'UndsStar'Word'UndsUnds'EVM-TYPES'Unds'Int'Unds'Int'Unds'Int.yaml
Lbl'Stop'Set	Lbl'Stop'Set.yaml
Lbl'Tild'Word'UndsUnds'EVM-TYPES'Unds'Int'Unds'Int	Lbl'Tild'Word'UndsUnds'EVM-TYPES'Unds'Int'Unds'Int.yaml
Lblproject'Coln'ExpectedOpcodeCellOpt	Lblproject'Coln'ExpectedOpcodeCellOpt.yaml
LblisExpectedRevertCellOpt	LblisExpectedRevertCellOpt.yaml
Lbl'Hash'rlpEncodeInt'LParUndsRParUnds'SERIALIZATION'Unds'Bytes'Unds'Int	Lbl'Hash'rlpEncodeInt'LParUndsRParUnds'SERIALIZATION'Unds'Bytes'Unds'Int.yaml
Lblproject'Coln'AccessListTxData'LParUndsCommUndsCommUndsCommUndsCommUndsCommUndsCommUndsCommUndsRParUnds'EVM-TYPES'Unds'AccessListTx'Unds'Int'Unds'Int'Unds'Int'Unds'Account'Unds'Int'Unds'Bytes'Unds'Int'Unds'JSONs'Coln'gasLimit	Lblproject'Coln'AccessListTxData'LParUndsCommUndsCommUndsCommUndsCommUndsCommUndsCommUndsCommUndsRParUnds'EVM-TYPES'Unds'AccessListTx'Unds'Int'Unds'Int'Unds'Int'Unds'Account'Unds'Int'Unds'Bytes'Unds'Int'Unds'JSONs'Coln'gasLimit.yaml
LblisInvalidOp	LblisInvalidOp.yaml
Lblproject'Coln'ActiveCell	Lblproject'Coln'ActiveCell.yaml
LblisStringBuffer	LblisStringBuffer.yaml
Lbl'Hash'hasValidInitCode'LParUndsCommUndsRParUnds'EVM'Unds'Bool'Unds'Int'Unds'Schedule	Lbl'Hash'hasValidInitCode'LParUndsCommUndsRParUnds'EVM'Unds'Bool'Unds'Int'Unds'Schedule.yaml
LblSet'Coln'in	LblSet'Coln'in.yaml
LblisExpectedOpcodeCell	LblisExpectedOpcodeCell.yaml
LblinitLogsBloomCell	LblinitLogsBloomCell.yaml
LblMerkleUpdateMapAux'LParUndsCommUndsCommUndsRParUnds'SERIALIZATION'Unds'MerkleTree'Unds'MerkleTree'Unds'Map'Unds'List	LblMerkleUpdateMapAux'LParUndsCommUndsCommUndsRParUnds'SERIALIZATION'Unds'MerkleTree'Unds'MerkleTree'Unds'Map'Unds'List.yaml
Lbl'Hash'usesMemory'LParUndsRParUnds'EVM'Unds'Bool'Unds'OpCode	Lbl'Hash'usesMemory'LParUndsRParUnds'EVM'Unds'Bool'Unds'OpCode.yaml
LblisUseGasCellOpt	LblisUseGasCellOpt.yaml
LblinitOriginCell	LblinitOriginCell.yaml
Lbl'Hash'stackDelta'LParUndsRParUnds'EVM'Unds'Int'Unds'OpCode	Lbl'Hash'stackDelta'LParUndsRParUnds'EVM'Unds'Int'Unds'OpCode.yaml
LblisOriginCellOpt	LblisOriginCellOpt.yaml
LblisStatusCode	LblisStatusCode.yaml
Lblsize'LParUndsRParUnds'MAP'Unds'Int'Unds'Map	Lblsize'LParUndsRParUnds'MAP'Unds'Int'Unds'Map.yaml
Lblproject'Coln'SingleCallCell	Lblproject'Coln'SingleCallCell.yaml
LblisTxData	LblisTxData.yaml
Lbl'Hash'nBytes'LParUndsRParUnds'EVM-TYPES'Unds'Int'Unds'Int	Lbl'Hash'nBytes'LParUndsRParUnds'EVM-TYPES'Unds'Int'Unds'Int.yaml
LblinitJumpDestsCell	LblinitJumpDestsCell.yaml
Lblmethod'Unds'lib'Perc'forge-std'Perc'src'Perc'StdInvariant	Lblmethod'Unds'lib'Perc'forge-std'Perc'src'Perc'StdInvariant.yaml
Lblproject'Coln'ExpectedRevertCellOpt	Lblproject'Coln'ExpectedRevertCellOpt.yaml
Lbl'Hash'point'LParUndsRParUnds'EVM'Unds'Bytes'Unds'G1Point	Lbl'Hash'point'LParUndsRParUnds'EVM'Unds'Bytes'Unds'G1Point.yaml
LblAccountCellMapKey	LblAccountCellMapKey.yaml
Lbl'Unds-LT--LT-'Word'UndsUnds'EVM-TYPES'Unds'Int'Unds'Int'Unds'Int	Lbl'Unds-LT--LT-'Word'UndsUnds'EVM-TYPES'Unds'Int'Unds'Int'Unds'Int.yaml
LblinitGeneratedTopCell	LblinitGeneratedTopCell.yaml
Lblsgn'LParUndsRParUnds'EVM-TYPES'Unds'Int'Unds'Int	Lblsgn'LParUndsRParUnds'EVM-TYPES'Unds'Int'Unds'Int.yaml
LblinitAccessedAccountsCell	LblinitAccessedAccountsCell.yaml
Lblproject'Coln'GasPriceCell	Lblproject'Coln'GasPriceCell.yaml
Lbl'Hash'hashedLocation'LParUndsCommUndsCommUndsRParUnds'HASHED-LOCATIONS'Unds'Int'Unds'String'Unds'Int'Unds'IntList	Lbl'Hash'hashedLocation'LParUndsCommUndsCommUndsRParUnds'HASHED-LOCATIONS'Unds'Int'Unds'String'Unds'Int'Unds'IntList.yaml
Lblproject'Coln'Schedule	Lblproject'Coln'Schedule.yaml
Lblsignextend'LParUndsCommUndsRParUnds'EVM-TYPES'Unds'Int'Unds'Int'Unds'Int	Lblsignextend'LParUndsCommUndsRParUnds'EVM-TYPES'Unds'Int'Unds'Int'Unds'Int.yaml
Lbl'Stop'Map	Lbl'Stop'Map.yaml
Lblproject'Coln'AccountCellMap	Lblproject'Coln'AccountCellMap.yaml
Lblproject'Coln'CallerCellOpt	Lblproject'Coln'CallerCellOpt.yaml
Lblproject'Coln'BalanceCell	Lblproject'Coln'BalanceCell.yaml
LblisMessagesCellOpt	LblisMessagesCellOpt.yaml
LblisNumberCellOpt	LblisNumberCellOpt.yaml
Lbllog2Int'LParUndsRParUnds'INT-COMMON'Unds'Int'Unds'Int	Lbllog2Int'LParUndsRParUnds'INT-COMMON'Unds'Int'Unds'Int.yaml
Lblproject'Coln'OpCode	Lblproject'Coln'OpCode.yaml
LblBN128Add'LParUndsCommUndsRParUnds'KRYPTO'Unds'G1Point'Unds'G1Point'Unds'G1Point	LblBN128Add'LParUndsCommUndsRParUnds'KRYPTO'Unds'G1Point'Unds'G1Point'Unds'G1Point.yaml
LblisPreviousHashCellOpt	LblisPreviousHashCellOpt.yaml
LblBytes2Int'LParUndsCommUndsCommUndsRParUnds'BYTES-HOOKED'Unds'Int'Unds'Bytes'Unds'Endianness'Unds'Signedness	LblBytes2Int'LParUndsCommUndsCommUndsRParUnds'BYTES-HOOKED'Unds'Int'Unds'Bytes'Unds'Endianness'Unds'Signedness.yaml
Lbl'Hash'replicate'LParUndsCommUndsRParUnds'EVM-TYPES'Unds'WordStack'Unds'Int'Unds'Int	Lbl'Hash'replicate'LParUndsCommUndsRParUnds'EVM-TYPES'Unds'WordStack'Unds'Int'Unds'Int.yaml
Lblproject'Coln'DepthCellOpt	Lblproject'Coln'DepthCellOpt.yaml
Lblproject'Coln'WithdrawalsRootCell	Lblproject'Coln'WithdrawalsRootCell.yaml
LblinitCallDataCell	LblinitCallDataCell.yaml
Lbl'Hash'changesState'LParUndsCommUndsRParUnds'EVM'Unds'Bool'Unds'OpCode'Unds'WordStack	Lbl'Hash'changesState'LParUndsCommUndsRParUnds'EVM'Unds'Bool'Unds'OpCode'Unds'WordStack.yaml
LblisCheckedDataCellOpt	LblisCheckedDataCellOpt.yaml
LblisPrankCellOpt	LblisPrankCellOpt.yaml
Lbl'Hash'sign'LParUndsCommUndsRParUnds'FOUNDRY-CHEAT-CODES'Unds'Bytes'Unds'Bytes'Unds'Bytes	Lbl'Hash'sign'LParUndsCommUndsRParUnds'FOUNDRY-CHEAT-CODES'Unds'Bytes'Unds'Bytes'Unds'Bytes.yaml
LblinitCheckedTopicsCell	LblinitCheckedTopicsCell.yaml
Lblproject'Coln'EvmCellFragment	Lblproject'Coln'EvmCellFragment.yaml
LblisWithdrawalsRootCellOpt	LblisWithdrawalsRootCellOpt.yaml
LblisMessagesCellFragment	LblisMessagesCellFragment.yaml
Lbl'Hash'allBut64th'LParUndsRParUnds'GAS-FEES'Unds'Gas'Unds'Gas	Lbl'Hash'allBut64th'LParUndsRParUnds'GAS-FEES'Unds'Gas'Unds'Gas.yaml
LblisCallDepthCellOpt	LblisCallDepthCellOpt.yaml
LblisGasUsedCellOpt	LblisGasUsedCellOpt.yaml
Lblproject'Coln'TxNonceCell	Lblproject'Coln'TxNonceCell.yaml
LblsubstrString'LParUndsCommUndsCommUndsRParUnds'STRING-COMMON'Unds'String'Unds'String'Unds'Int'Unds'Int	LblsubstrString'LParUndsCommUndsCommUndsRParUnds'STRING-COMMON'Unds'String'Unds'String'Unds'Int'Unds'Int.yaml
LblisFoundryCellOpt	LblisFoundryCellOpt.yaml
LblisS2KlibZModforgeZSubstdZModsrcZModCommonBaseContract	LblisS2KlibZModforgeZSubstdZModsrcZModCommonBaseContract.yaml
LblisS2KlibZModforgeZSubstdZModsrcZModmocksZModMockERC20Method	LblisS2KlibZModforgeZSubstdZModsrcZModmocksZModMockERC20Method.yaml
Lbl'UndsXor-'Int'Unds'	Lbl'UndsXor-'Int'Unds'.yaml
Lblproject'Coln'GasPriceCellOpt	Lblproject'Coln'GasPriceCellOpt.yaml
Lbl'Hash'buf'LParUndsCommUndsRParUnds'BUF-SYNTAX'Unds'Bytes'Unds'Int'Unds'Int	Lbl'Hash'buf'LParUndsCommUndsRParUnds'BUF-SYNTAX'Unds'Bytes'Unds'Int'Unds'Int.yaml
LblinitCodeCell	LblinitCodeCell.yaml
LblisCallerCell	LblisCallerCell.yaml
LblisBalanceCell	LblisBalanceCell.yaml
LblisExpectedAddressCellOpt	LblisExpectedAddressCellOpt.yaml
Lblproject'Coln'GasLimitCellOpt	Lblproject'Coln'GasLimitCellOpt.yaml
LblListItem	LblListItem.yaml
Lblproject'Coln'ContractAccess	Lblproject'Coln'ContractAccess.yaml
Lblproject'Coln'S2KlibZModkontrolZSubcheatcodesZModsrcZModKontrolCheatsMethod	Lblproject'Coln'S2KlibZModkontrolZSubcheatcodesZModsrcZModKontrolCheatsMethod.yaml
Lbl'Hash'blockhash'LParUndsCommUndsCommUndsCommUndsRParUnds'EVM'Unds'Int'Unds'List'Unds'Int'Unds'Int'Unds'Int	Lbl'Hash'blockhash'LParUndsCommUndsCommUndsCommUndsRParUnds'EVM'Unds'Int'Unds'List'Unds'Int'Unds'Int'Unds'Int.yaml
LblisSubstateCell	LblisSubstateCell.yaml
LblBlake2Compressbytes'LParUndsRParUnds'SERIALIZATION'Unds'String'Unds'Bytes	LblBlake2Compressbytes'LParUndsRParUnds'SERIALIZATION'Unds'String'Unds'Bytes.yaml
LblisNonceCellOpt	LblisNonceCellOpt.yaml
Lblproject'Coln'Field	Lblproject'Coln'Field.yaml
LblremoveAll'LParUndsCommUndsRParUnds'MAP'Unds'Map'Unds'Map'Unds'Set	LblremoveAll'LParUndsCommUndsRParUnds'MAP'Unds'Map'Unds'Map'Unds'Set.yaml
LblinitPrevCallerCell	LblinitPrevCallerCell.yaml
Lbl'Hash'asInteger'LParUndsRParUnds'EVM-TYPES'Unds'Int'Unds'Bytes	Lbl'Hash'asInteger'LParUndsRParUnds'EVM-TYPES'Unds'Int'Unds'Bytes.yaml
Lblproject'Coln'CoinbaseCellOpt	Lblproject'Coln'CoinbaseCellOpt.yaml
Lblproject'Coln'StateRootCell	Lblproject'Coln'StateRootCell.yaml
Lbl'UndsEqlsSlshEqls'Int'Unds'	Lbl'UndsEqlsSlshEqls'Int'Unds'.yaml
Lbl'Hash'hashSignedTx'LParUndsCommUndsCommUndsCommUndsCommUndsCommUndsCommUndsCommUndsCommUndsRParUnds'SERIALIZATION'Unds'String'Unds'Int'Unds'Int'Unds'Int'Unds'Account'Unds'Int'Unds'Bytes'Unds'Int'Unds'Bytes'Unds'Bytes	Lbl'Hash'hashSignedTx'LParUndsCommUndsCommUndsCommUndsCommUndsCommUndsCommUndsCommUndsCommUndsRParUnds'SERIALIZATION'Unds'String'Unds'Int'Unds'Int'Unds'Int'Unds'Account'Unds'Int'Unds'Bytes'Unds'Int'Unds'Bytes'Unds'Bytes.yaml
Lbl'Hash'parseByteStack'LParUndsRParUnds'SERIALIZATION'Unds'Bytes'Unds'String	Lbl'Hash'parseByteStack'LParUndsRParUnds'SERIALIZATION'Unds'Bytes'Unds'String.yaml
Lbl'Unds'andThenBool'Unds'	Lbl'Unds'andThenBool'Unds'.yaml
LblisPreviousHashCell	LblisPreviousHashCell.yaml
Lbl'Unds-LT--LT-Unds-GT--GT-Unds'SCHEDULE'Unds'Bool'Unds'ScheduleFlag'Unds'Schedule	Lbl'Unds-LT--LT-Unds-GT--GT-Unds'SCHEDULE'Unds'Bool'Unds'ScheduleFlag'Unds'Schedule.yaml
Lblkeccak'LParUndsRParUnds'SERIALIZATION'Unds'Int'Unds'Bytes	Lblkeccak'LParUndsRParUnds'SERIALIZATION'Unds'Int'Unds'Bytes.yaml
LblisAccountCode	LblisAccountCode.yaml
Lblproject'Coln'AccessListTx	Lblproject'Coln'AccessListTx.yaml
Lbl'Hash'addr'LParUndsRParUnds'EVM-TYPES'Unds'Int'Unds'Int	Lbl'Hash'addr'LParUndsRParUnds'EVM-TYPES'Unds'Int'Unds'Int.yaml
LblisFoundryCell	LblisFoundryCell.yaml
LblisAccountCellFragment	LblisAccountCellFragment.yaml
Lblproject'Coln'KevmCellFragment	Lblproject'Coln'KevmCellFragment.yaml
Lblproject'Coln'TxGasLimitCell	Lblproject'Coln'TxGasLimitCell.yaml
LblgetGeneratedCounterCell	LblgetGeneratedCounterCell.yaml
LblMerkleUpdateMap'LParUndsCommUndsRParUnds'SERIALIZATION'Unds'MerkleTree'Unds'MerkleTree'Unds'Map	LblMerkleUpdateMap'LParUndsCommUndsRParUnds'SERIALIZATION'Unds'MerkleTree'Unds'MerkleTree'Unds'Map.yaml
LblisTxChainIDCell	LblisTxChainIDCell.yaml
Lblproject'Coln'CallDataCell	Lblproject'Coln'CallDataCell.yaml
LblisCallValueCellOpt	LblisCallValueCellOpt.yaml
Lbl'Hash'nBits'LParUndsRParUnds'EVM-TYPES'Unds'Int'Unds'Int	Lbl'Hash'nBits'LParUndsRParUnds'EVM-TYPES'Unds'Int'Unds'Int.yaml
Lblproject'Coln'AccessListTxData'LParUndsCommUndsCommUndsCommUndsCommUndsCommUndsCommUndsCommUndsRParUnds'EVM-TYPES'Unds'AccessListTx'Unds'Int'Unds'Int'Unds'Int'Unds'Account'Unds'Int'Unds'Bytes'Unds'Int'Unds'JSONs'Coln'nonce	Lblproject'Coln'AccessListTxData'LParUndsCommUndsCommUndsCommUndsCommUndsCommUndsCommUndsCommUndsRParUnds'EVM-TYPES'Unds'AccessListTx'Unds'Int'Unds'Int'Unds'Int'Unds'Account'Unds'Int'Unds'Bytes'Unds'Int'Unds'JSONs'Coln'nonce.yaml
Lblproject'Coln'StatusCode	Lblproject'Coln'StatusCode.yaml
LblisCallStackCellOpt	LblisCallStackCellOpt.yaml
Lblproject'Coln'GasCellOpt	Lblproject'Coln'GasCellOpt.yaml
Lbl'UndsLSqBUnds-LT-'-'UndsRSqBUnds'BYTES-HOOKED'Unds'Bytes'Unds'Bytes'Unds'Int'Unds'Int	Lbl'UndsLSqBUnds-LT-'-'UndsRSqBUnds'BYTES-HOOKED'Unds'Bytes'Unds'Bytes'Unds'Int'Unds'Int.yaml
Lbl'Hash'lookupOpCode'LParUndsCommUndsCommUndsRParUnds'EVM'Unds'MaybeOpCode'Unds'Bytes'Unds'Int'Unds'Schedule	Lbl'Hash'lookupOpCode'LParUndsCommUndsCommUndsRParUnds'EVM'Unds'MaybeOpCode'Unds'Bytes'Unds'Int'Unds'Schedule.yaml
Lblproject'Coln'LegacyTx	Lblproject'Coln'LegacyTx.yaml
Lblproject'Coln'LegacyTxData'LParUndsCommUndsCommUndsCommUndsCommUndsCommUndsRParUnds'EVM-TYPES'Unds'LegacyTx'Unds'Int'Unds'Int'Unds'Int'Unds'Account'Unds'Int'Unds'Bytes'Coln'gasLimit	Lblproject'Coln'LegacyTxData'LParUndsCommUndsCommUndsCommUndsCommUndsCommUndsRParUnds'EVM-TYPES'Unds'LegacyTx'Unds'Int'Unds'Int'Unds'Int'Unds'Account'Unds'Int'Unds'Bytes'Coln'gasLimit.yaml
Lblproject'Coln'S2KlibZModforgeZSubstdZModsrcZModStdChainsContract	Lblproject'Coln'S2KlibZModforgeZSubstdZModsrcZModStdChainsContract.yaml
LblinitKevmCell	LblinitKevmCell.yaml
LblECDSAPubKeybytes'LParUndsRParUnds'SERIALIZATION'Unds'String'Unds'Bytes	LblECDSAPubKeybytes'LParUndsRParUnds'SERIALIZATION'Unds'String'Unds'Bytes.yaml
Lblproject'Coln'TxMaxFeeCell	Lblproject'Coln'TxMaxFeeCell.yaml
LblisWhitelistCell	LblisWhitelistCell.yaml
LblisOmmersHashCell	LblisOmmersHashCell.yaml
LblinitAccountCell	LblinitAccountCell.yaml
LblminInt'LParUndsCommUndsRParUnds'INT-COMMON'Unds'Int'Unds'Int'Unds'Int	LblminInt'LParUndsCommUndsRParUnds'INT-COMMON'Unds'Int'Unds'Int'Unds'Int.yaml
LblisGasLimitCell	LblisGasLimitCell.yaml
Lblproject'Coln'LegacyProtectedTxData'LParUndsCommUndsCommUndsCommUndsCommUndsCommUndsCommUndsRParUnds'EVM-TYPES'Unds'LegacyTx'Unds'Int'Unds'Int'Unds'Int'Unds'Account'Unds'Int'Unds'Bytes'Unds'Int'Coln'nonce	Lblproject'Coln'LegacyProtectedTxData'LParUndsCommUndsCommUndsCommUndsCommUndsCommUndsCommUndsRParUnds'EVM-TYPES'Unds'LegacyTx'Unds'Int'Unds'Int'Unds'Int'Unds'Account'Unds'Int'Unds'Bytes'Unds'Int'Coln'nonce.yaml
LblisMsgIDCell	LblisMsgIDCell.yaml
Lblproject'Coln'CallStackCellOpt	Lblproject'Coln'CallStackCellOpt.yaml
Lbl'UndsLSqBUnds-LT-'-undef'RSqB'	Lbl'UndsLSqBUnds-LT-'-undef'RSqB'.yaml
LblisDynamicFeeTx	LblisDynamicFeeTx.yaml
LblisField	LblisField.yaml
Lblproject'Coln'ProgramCell	Lblproject'Coln'ProgramCell.yaml
LbllistAsBytes'LParUndsRParUnds'EVM'Unds'List'Unds'List	LbllistAsBytes'LParUndsRParUnds'EVM'Unds'List'Unds'List.yaml
Lblmethod'Unds'lib'Perc'forge-std'Perc'src'Perc'mocks'Perc'MockERC20	Lblmethod'Unds'lib'Perc'forge-std'Perc'src'Perc'mocks'Perc'MockERC20.yaml
Lbl'Hash'if'UndsHash'then'UndsHash'else'UndsHash'fi'Unds'K-EQUAL-SYNTAX'Unds'Sort'Unds'Bool'Unds'Sort'Unds'Sort	Lbl'Hash'if'UndsHash'then'UndsHash'else'UndsHash'fi'Unds'K-EQUAL-SYNTAX'Unds'Sort'Unds'Bool'Unds'Sort'Unds'Sort.yaml
LblisPushOp	LblisPushOp.yaml
LblSha256'LParUndsRParUnds'KRYPTO'Unds'String'Unds'String	LblSha256'LParUndsRParUnds'KRYPTO'Unds'String'Unds'String.yaml
Lblproject'Coln'MessagesCellFragment	Lblproject'Coln'MessagesCellFragment.yaml
LblisExpectedAddressCell	LblisExpectedAddressCell.yaml
Lbl'Unds'MessageCellMap'Unds'	Lbl'Unds'MessageCellMap'Unds'.yaml
Lbllog256Int'LParUndsRParUnds'EVM-TYPES'Unds'Int'Unds'Int	Lbllog256Int'LParUndsRParUnds'EVM-TYPES'Unds'Int'Unds'Int.yaml
Lbl'Hash'rlpEncodeLength'LParUndsCommUndsRParUnds'SERIALIZATION'Unds'Bytes'Unds'Bytes'Unds'Int	Lbl'Hash'rlpEncodeLength'LParUndsCommUndsRParUnds'SERIALIZATION'Unds'Bytes'Unds'Bytes'Unds'Int.yaml
LblisBlockCellFragment	LblisBlockCellFragment.yaml
LblisS2KlibZModforgeZSubstdZModsrcZModstdStorageSafeContract	LblisS2KlibZModforgeZSubstdZModsrcZModstdStorageSafeContract.yaml
Lbl'Hash'rlpEncodeString'LParUndsRParUnds'SERIALIZATION'Unds'Bytes'Unds'String	Lbl'Hash'rlpEncodeString'LParUndsRParUnds'SERIALIZATION'Unds'Bytes'Unds'String.yaml
LblisNumberCell	LblisNumberCell.yaml
Lbl'Hash'dasmTxPrefix'LParUndsRParUnds'EVM-TYPES'Unds'Int'Unds'TxType	Lbl'Hash'dasmTxPrefix'LParUndsRParUnds'EVM-TYPES'Unds'Int'Unds'TxType.yaml
LblinitBalanceCell	LblinitBalanceCell.yaml
Lblmethod'Unds'lib'Perc'forge-std'Perc'src'Perc'StdAssertions	Lblmethod'Unds'lib'Perc'forge-std'Perc'src'Perc'StdAssertions.yaml
Lblproject'Coln'ToCell	Lblproject'Coln'ToCell.yaml
Lblproject'Coln'BlockhashesCellOpt	Lblproject'Coln'BlockhashesCellOpt.yaml
LblisWhitelistCellOpt	LblisWhitelistCellOpt.yaml
LblCextcodehash'LParUndsRParUnds'GAS-FEES'Unds'Int'Unds'Schedule	LblCextcodehash'LParUndsRParUnds'GAS-FEES'Unds'Int'Unds'Schedule.yaml
Lblproject'Coln'BaseFeeCellOpt	Lblproject'Coln'BaseFeeCellOpt.yaml
Lblproject'Coln'IdCellOpt	Lblproject'Coln'IdCellOpt.yaml
LblisInt	LblisInt.yaml
LblisS2KlibZModforgeZSubstdZModsrcZModmocksZModMockERC721Method	LblisS2KlibZModforgeZSubstdZModsrcZModmocksZModMockERC721Method.yaml
LblnotBool'Unds'	LblnotBool'Unds'.yaml
Lblproject'Coln'LegacyProtectedTxData'LParUndsCommUndsCommUndsCommUndsCommUndsCommUndsCommUndsRParUnds'EVM-TYPES'Unds'LegacyTx'Unds'Int'Unds'Int'Unds'Int'Unds'Account'Unds'Int'Unds'Bytes'Unds'Int'Coln'value	Lblproject'Coln'LegacyProtectedTxData'LParUndsCommUndsCommUndsCommUndsCommUndsCommUndsCommUndsRParUnds'EVM-TYPES'Unds'LegacyTx'Unds'Int'Unds'Int'Unds'Int'Unds'Account'Unds'Int'Unds'Bytes'Unds'Int'Coln'value.yaml
LblisTouchedAccountsCellOpt	LblisTouchedAccountsCellOpt.yaml
Lblmethod'Unds'lib'Perc'forge-std'Perc'src'Perc'Test	Lblmethod'Unds'lib'Perc'forge-std'Perc'src'Perc'Test.yaml
Lbl'Hash'rlpEncodeReceipt'LParUndsCommUndsCommUndsCommUndsRParUnds'SERIALIZATION'Unds'Bytes'Unds'Int'Unds'Int'Unds'Bytes'Unds'List	Lbl'Hash'rlpEncodeReceipt'LParUndsCommUndsCommUndsCommUndsRParUnds'SERIALIZATION'Unds'Bytes'Unds'Int'Unds'Int'Unds'Bytes'Unds'List.yaml
LblisIsRevertExpectedCell	LblisIsRevertExpectedCell.yaml
LblisPrevCallerCellOpt	LblisPrevCallerCellOpt.yaml
Lblproject'Coln'IdCell	Lblproject'Coln'IdCell.yaml
Lblproject'Coln'StackOp	Lblproject'Coln'StackOp.yaml
Lbl'Hash'sizeWordStack'LParUndsCommUndsRParUnds'EVM-TYPES'Unds'Int'Unds'WordStack'Unds'Int	Lbl'Hash'sizeWordStack'LParUndsCommUndsRParUnds'EVM-TYPES'Unds'Int'Unds'WordStack'Unds'Int.yaml
Lblproject'Coln'Account	Lblproject'Coln'Account.yaml
Lbl'Hash'sender'LParUndsCommUndsCommUndsCommUndsRParUnds'SERIALIZATION'Unds'Account'Unds'TxData'Unds'Int'Unds'Bytes'Unds'Bytes	Lbl'Hash'sender'LParUndsCommUndsCommUndsCommUndsRParUnds'SERIALIZATION'Unds'Account'Unds'TxData'Unds'Int'Unds'Bytes'Unds'Bytes.yaml
Lblproject'Coln'Bytes	Lblproject'Coln'Bytes.yaml
LblisIsCallWhitelistActiveCell	LblisIsCallWhitelistActiveCell.yaml
LblinitExpectEmitCell	LblinitExpectEmitCell.yaml
Lblproject'Coln'CallGasCellOpt	Lblproject'Coln'CallGasCellOpt.yaml
Lblproject'Coln'LogsBloomCellOpt	Lblproject'Coln'LogsBloomCellOpt.yaml
Lbl'Unds-GT-'Int'Unds'	Lbl'Unds-GT-'Int'Unds'.yaml
Lblproject'Coln'StorageCell	Lblproject'Coln'StorageCell.yaml
LblinitPcCell	LblinitPcCell.yaml
Lblproject'Coln'BaseFeeCell	Lblproject'Coln'BaseFeeCell.yaml
Lblproject'Coln'ExpectedAddressCellOpt	Lblproject'Coln'ExpectedAddressCellOpt.yaml
LblCaddraccess'LParUndsCommUndsRParUnds'GAS-FEES'Unds'Int'Unds'Schedule'Unds'Bool	LblCaddraccess'LParUndsCommUndsRParUnds'GAS-FEES'Unds'Int'Unds'Schedule'Unds'Bool.yaml
LblisCheckedTopicsCell	LblisCheckedTopicsCell.yaml
Lblproject'Coln'CheckedTopicsCell	Lblproject'Coln'CheckedTopicsCell.yaml
Lbl'Hash'if'UndsHash'then'UndsHash'else'UndsHash'fi'Unds'K-EQUAL-SYNTAX'Unds'Sort'Unds'Bool'Unds'Sort'Unds'Sort	Lbl'Hash'if'UndsHash'then'UndsHash'else'UndsHash'fi'Unds'K-EQUAL-SYNTAX'Unds'Sort'Unds'Bool'Unds'Sort'Unds'Sort.yaml
Lbl'Unds-GT-Eqls'Word'UndsUnds'EVM-TYPES'Unds'Int'Unds'Int'Unds'Int	Lbl'Unds-GT-Eqls'Word'UndsUnds'EVM-TYPES'Unds'Int'Unds'Int'Unds'Int.yaml
Lblproject'Coln'ExpectedRevertCell	Lblproject'Coln'ExpectedRevertCell.yaml
Lbl'Hash'rlpEncodeAddress'LParUndsRParUnds'SERIALIZATION'Unds'Bytes'Unds'Account	Lbl'Hash'rlpEncodeAddress'LParUndsRParUnds'SERIALIZATION'Unds'Bytes'Unds'Account.yaml
Lblproject'Coln'BlockCellOpt	Lblproject'Coln'BlockCellOpt.yaml
LbllengthString'LParUndsRParUnds'STRING-COMMON'Unds'Int'Unds'String	LbllengthString'LParUndsRParUnds'STRING-COMMON'Unds'Int'Unds'String.yaml
LblisTypedArgs	LblisTypedArgs.yaml
LblisModeCellOpt	LblisModeCellOpt.yaml
Lbl'Hash'modexp3'LParUndsCommUndsCommUndsCommUndsRParUnds'EVM'Unds'Bytes'Unds'Int'Unds'Int'Unds'Int'Unds'Bytes	Lbl'Hash'modexp3'LParUndsCommUndsCommUndsCommUndsRParUnds'EVM'Unds'Bytes'Unds'Int'Unds'Int'Unds'Int'Unds'Bytes.yaml
Lblproject'Coln'TxData	Lblproject'Coln'TxData.yaml
Lblproject'Coln'OutputCellOpt	Lblproject'Coln'OutputCellOpt.yaml
LblECDSAPubKey'LParUndsRParUnds'KRYPTO'Unds'String'Unds'String	LblECDSAPubKey'LParUndsRParUnds'KRYPTO'Unds'String'Unds'String.yaml
LblMerkleDelete'LParUndsCommUndsRParUnds'SERIALIZATION'Unds'MerkleTree'Unds'MerkleTree'Unds'Bytes	LblMerkleDelete'LParUndsCommUndsRParUnds'SERIALIZATION'Unds'MerkleTree'Unds'MerkleTree'Unds'Bytes.yaml
Lbl'Hash'rlpEncodeFullAccount'LParUndsCommUndsCommUndsCommUndsRParUnds'SERIALIZATION'Unds'Bytes'Unds'Int'Unds'Int'Unds'Map'Unds'Bytes	Lbl'Hash'rlpEncodeFullAccount'LParUndsCommUndsCommUndsCommUndsRParUnds'SERIALIZATION'Unds'Bytes'Unds'Int'Unds'Int'Unds'Map'Unds'Bytes.yaml
Lbl'Hash'generateSignature'LParUndsCommUndsRParUnds'EVM-ABI'Unds'String'Unds'String'Unds'TypedArgs	Lbl'Hash'generateSignature'LParUndsCommUndsRParUnds'EVM-ABI'Unds'String'Unds'String'Unds'TypedArgs.yaml
Lbl'Hash'blockHashHeaderBaseFeeBytes	Lbl'Hash'blockHashHeaderBaseFeeBytes.yaml
Lbl'UndsPlus'Bytes'UndsUnds'BYTES-HOOKED'Unds'Bytes'Unds'Bytes'Unds'Bytes	Lbl'UndsPlus'Bytes'UndsUnds'BYTES-HOOKED'Unds'Bytes'Unds'Bytes'Unds'Bytes.yaml
LblinitActiveCell	LblinitActiveCell.yaml
Lblproject'Coln'IsStorageWhitelistActiveCell	Lblproject'Coln'IsStorageWhitelistActiveCell.yaml
Lbl'Hash'lookupMemory'LParUndsCommUndsRParUnds'EVM-TYPES'Unds'Int'Unds'Map'Unds'Int	Lbl'Hash'lookupMemory'LParUndsCommUndsRParUnds'EVM-TYPES'Unds'Int'Unds'Map'Unds'Int.yaml
LblinitDataCell	LblinitDataCell.yaml
Lblproject'Coln'NetworkCell	Lblproject'Coln'NetworkCell.yaml
Lblproject'Coln'DynamicFeeTxData'LParUndsCommUndsCommUndsCommUndsCommUndsCommUndsCommUndsCommUndsCommUndsRParUnds'EVM-TYPES'Unds'DynamicFeeTx'Unds'Int'Unds'Int'Unds'Int'Unds'Int'Unds'Account'Unds'Int'Unds'Bytes'Unds'Int'Unds'JSONs'Coln'maxGasFee	Lblproject'Coln'DynamicFeeTxData'LParUndsCommUndsCommUndsCommUndsCommUndsCommUndsCommUndsCommUndsCommUndsRParUnds'EVM-TYPES'Unds'DynamicFeeTx'Unds'Int'Unds'Int'Unds'Int'Unds'Int'Unds'Account'Unds'Int'Unds'Bytes'Unds'Int'Unds'JSONs'Coln'maxG279.yaml
Lblproject'Coln'S2KlibZModforgeZSubstdZModsrcZModStdUtilsContract	Lblproject'Coln'S2KlibZModforgeZSubstdZModsrcZModStdUtilsContract.yaml
Lblmethod'Unds'lib'Perc'forge-std'Perc'src'Perc'Script	Lblmethod'Unds'lib'Perc'forge-std'Perc'src'Perc'Script.yaml
Lblproject'Coln'AddressSetCellOpt	Lblproject'Coln'AddressSetCellOpt.yaml
LblisSingleCallCellOpt	LblisSingleCallCellOpt.yaml
Lbl'Hash'parseAccessListStorageKeys'LParUndsCommUndsRParUnds'SERIALIZATION'Unds'List'Unds'JSONs'Unds'List	Lbl'Hash'parseAccessListStorageKeys'LParUndsCommUndsRParUnds'SERIALIZATION'Unds'List'Unds'JSONs'Unds'List.yaml
Lbl'Unds'xorInt'Unds'	Lbl'Unds'xorInt'Unds'.yaml
LblfindChar'LParUndsCommUndsCommUndsRParUnds'STRING-COMMON'Unds'Int'Unds'String'Unds'String'Unds'Int	LblfindChar'LParUndsCommUndsCommUndsRParUnds'STRING-COMMON'Unds'Int'Unds'String'Unds'String'Unds'Int.yaml
LblBase2String'LParUndsCommUndsRParUnds'STRING-COMMON'Unds'String'Unds'Int'Unds'Int	LblBase2String'LParUndsCommUndsRParUnds'STRING-COMMON'Unds'String'Unds'Int'Unds'Int.yaml
LblisNewOriginCell	LblisNewOriginCell.yaml
Lblproject'Coln'CallGasCell	Lblproject'Coln'CallGasCell.yaml
LblinitTxGasPriceCell	LblinitTxGasPriceCell.yaml
Lblproject'Coln'S2KlibZModforgeZSubstdZModsrcZModStdInvariantMethod	Lblproject'Coln'S2KlibZModforgeZSubstdZModsrcZModStdInvariantMethod.yaml
LblisMap	LblisMap.yaml
Lblproject'Coln'Set	Lblproject'Coln'Set.yaml
Lblproject'Coln'SigVCellOpt	Lblproject'Coln'SigVCellOpt.yaml
LblinitExpectedReasonCell	LblinitExpectedReasonCell.yaml
Lblproject'Coln'StorageSlotSetCellOpt	Lblproject'Coln'StorageSlotSetCellOpt.yaml
LblisPrevCallerCell	LblisPrevCallerCell.yaml
Lblproject'Coln'IsRevertExpectedCellOpt	Lblproject'Coln'IsRevertExpectedCellOpt.yaml
Lbl'Hash'modexp1'LParUndsCommUndsCommUndsCommUndsRParUnds'EVM'Unds'Bytes'Unds'Int'Unds'Int'Unds'Int'Unds'Bytes	Lbl'Hash'modexp1'LParUndsCommUndsCommUndsCommUndsRParUnds'EVM'Unds'Bytes'Unds'Int'Unds'Int'Unds'Int'Unds'Bytes.yaml
Lblproject'Coln'KCellOpt	Lblproject'Coln'KCellOpt.yaml
Lblproject'Coln'SigRCellOpt	Lblproject'Coln'SigRCellOpt.yaml
LblisCallStateCell	LblisCallStateCell.yaml
Lblproject'Coln'ExpectedValueCell	Lblproject'Coln'ExpectedValueCell.yaml
Lblproject'Coln'ProgramCellOpt	Lblproject'Coln'ProgramCellOpt.yaml
Lblproject'Coln'RecordEventCell	Lblproject'Coln'RecordEventCell.yaml
LblMessageCellMapKey	LblMessageCellMapKey.yaml
Lblproject'Coln'ScheduleCellOpt	Lblproject'Coln'ScheduleCellOpt.yaml
Lblproject'Coln'LocalMemCellOpt	Lblproject'Coln'LocalMemCellOpt.yaml
LblisStaticCell	LblisStaticCell.yaml
LblisStaticCellOpt	LblisStaticCellOpt.yaml
Lbl'Hash'enc'LParUndsRParUnds'EVM-ABI'Unds'Bytes'Unds'TypedArg	Lbl'Hash'enc'LParUndsRParUnds'EVM-ABI'Unds'Bytes'Unds'TypedArg.yaml
Lbl'Hash'range'LParUndsCommUndsCommUndsRParUnds'EVM-TYPES'Unds'Bytes'Unds'Bytes'Unds'Int'Unds'Int	Lbl'Hash'range'LParUndsCommUndsCommUndsRParUnds'EVM-TYPES'Unds'Bytes'Unds'Bytes'Unds'Int'Unds'Int.yaml
LblinitTransactionsRootCell	LblinitTransactionsRootCell.yaml
LblCstorageaccess'LParUndsCommUndsRParUnds'GAS-FEES'Unds'Int'Unds'Schedule'Unds'Bool	LblCstorageaccess'LParUndsCommUndsRParUnds'GAS-FEES'Unds'Int'Unds'Schedule'Unds'Bool.yaml
LblisExpectedReasonCellOpt	LblisExpectedReasonCellOpt.yaml
Lblproject'Coln'AccessedStorageCell	Lblproject'Coln'AccessedStorageCell.yaml
Lbl'Unds-LT-Eqls'String'UndsUnds'STRING-COMMON'Unds'Bool'Unds'String'Unds'String	Lbl'Unds-LT-Eqls'String'UndsUnds'STRING-COMMON'Unds'Bool'Unds'String'Unds'String.yaml
LblisS2KlibZModforgeZSubstdZModsrcZModTestContract	LblisS2KlibZModforgeZSubstdZModsrcZModTestContract.yaml
LblisS2KlibZModkontrolZSubcheatcodesZModsrcZModKontrolCheatsContract	LblisS2KlibZModkontrolZSubcheatcodesZModsrcZModKontrolCheatsContract.yaml
LblisStorageCellOpt	LblisStorageCellOpt.yaml
LblisS2KlibZModforgeZSubstdZModsrcZModmocksZModMockERC20Contract	LblisS2KlibZModforgeZSubstdZModsrcZModmocksZModMockERC20Contract.yaml
LblisAccessedStorageCellOpt	LblisAccessedStorageCellOpt.yaml
LblisGasLimitCellOpt	LblisGasLimitCellOpt.yaml
Lbl'Hash'padToWidth'LParUndsCommUndsRParUnds'EVM-TYPES'Unds'Bytes'Unds'Int'Unds'Bytes	Lbl'Hash'padToWidth'LParUndsCommUndsRParUnds'EVM-TYPES'Unds'Bytes'Unds'Int'Unds'Bytes.yaml
Lbl'Unds'orBool'Unds'	Lbl'Unds'orBool'Unds'.yaml
LblCextra'LParUndsCommUndsCommUndsCommUndsRParUnds'GAS-FEES'Unds'Int'Unds'Schedule'Unds'Bool'Unds'Int'Unds'Bool	LblCextra'LParUndsCommUndsCommUndsCommUndsRParUnds'GAS-FEES'Unds'Int'Unds'Schedule'Unds'Bool'Unds'Int'Unds'Bool.yaml
LblisOpCode	LblisOpCode.yaml
Lblproject'Coln'Contract	Lblproject'Coln'Contract.yaml
LblisStatusCodeCellOpt	LblisStatusCodeCellOpt.yaml
Lbl'Unds-LT-'Word'UndsUnds'EVM-TYPES'Unds'Int'Unds'Int'Unds'Int	Lbl'Unds-LT-'Word'UndsUnds'EVM-TYPES'Unds'Int'Unds'Int'Unds'Int.yaml
Lbl'Hash'rlpDecode'LParUndsRParUnds'SERIALIZATION'Unds'JSON'Unds'Bytes	Lbl'Hash'rlpDecode'LParUndsRParUnds'SERIALIZATION'Unds'JSON'Unds'Bytes.yaml
Lblproject'Coln'S2KlibZModforgeZSubstdZModsrcZModstdMathContract	Lblproject'Coln'S2KlibZModforgeZSubstdZModsrcZModstdMathContract.yaml
LblInt2String'LParUndsRParUnds'STRING-COMMON'Unds'String'Unds'Int	LblInt2String'LParUndsRParUnds'STRING-COMMON'Unds'String'Unds'Int.yaml
LblisCoinbaseCellOpt	LblisCoinbaseCellOpt.yaml
LblisSubstateCellOpt	LblisSubstateCellOpt.yaml
Lblproject'Coln'BalanceCellOpt	Lblproject'Coln'BalanceCellOpt.yaml
Lbl'Hash'merkleUpdateBranch'LParUndsCommUndsCommUndsCommUndsCommUndsRParUnds'SERIALIZATION'Unds'MerkleTree'Unds'Map'Unds'String'Unds'Int'Unds'Bytes'Unds'String	Lbl'Hash'merkleUpdateBranch'LParUndsCommUndsCommUndsCommUndsCommUndsRParUnds'SERIALIZATION'Unds'MerkleTree'Unds'Map'Unds'String'Unds'Int'Unds'Bytes'Unds'String.yaml
Lblproject'Coln'SigVCell	Lblproject'Coln'SigVCell.yaml
Lblproject'Coln'CallerCell	Lblproject'Coln'CallerCell.yaml
Lblproject'Coln'FoundryCellOpt	Lblproject'Coln'FoundryCellOpt.yaml
LblisIsEventExpectedCell	LblisIsEventExpectedCell.yaml
LblisTxGasPriceCell	LblisTxGasPriceCell.yaml
Lblproject'Coln'NetworkCellOpt	Lblproject'Coln'NetworkCellOpt.yaml
LblinitKCell	LblinitKCell.yaml
LblisAccountCell	LblisAccountCell.yaml
LblinitIsEventExpectedCell	LblinitIsEventExpectedCell.yaml
Lbl'Hash'newAddr'LParUndsCommUndsRParUnds'SERIALIZATION'Unds'Int'Unds'Int'Unds'Int	Lbl'Hash'newAddr'LParUndsCommUndsRParUnds'SERIALIZATION'Unds'Int'Unds'Int'Unds'Int.yaml
Lbl'Unds-GT-'Word'UndsUnds'EVM-TYPES'Unds'Int'Unds'Int'Unds'Int	Lbl'Unds-GT-'Word'UndsUnds'EVM-TYPES'Unds'Int'Unds'Int'Unds'Int.yaml
LblisPcCellOpt	LblisPcCellOpt.yaml
LblisTxAccessCellOpt	LblisTxAccessCellOpt.yaml
Lblproject'Coln'StaticCellOpt	Lblproject'Coln'StaticCellOpt.yaml
Lblproject'Coln'CallOp	Lblproject'Coln'CallOp.yaml
Lbl'Hash'addrBytes'LParUndsRParUnds'SERIALIZATION'Unds'Bytes'Unds'Account	Lbl'Hash'addrBytes'LParUndsRParUnds'SERIALIZATION'Unds'Bytes'Unds'Account.yaml
Lblproject'Coln'StaticCell	Lblproject'Coln'StaticCell.yaml
Lbl'Unds'andBool'Unds'	Lbl'Unds'andBool'Unds'.yaml
LblisEvmCellFragment	LblisEvmCellFragment.yaml
Lbl'UndsPlus'JSONs'UndsUnds'JSON-EXT'Unds'JSONs'Unds'JSONs'Unds'JSONs	Lbl'UndsPlus'JSONs'UndsUnds'JSON-EXT'Unds'JSONs'Unds'JSONs'Unds'JSONs.yaml
Lblproject'Coln'PrankCellOpt	Lblproject'Coln'PrankCellOpt.yaml
Lblproject'Coln'LogOp	Lblproject'Coln'LogOp.yaml
LblisActiveCell	LblisActiveCell.yaml
Lbl'Hash'parseAddr'LParUndsRParUnds'SERIALIZATION'Unds'Int'Unds'String	Lbl'Hash'parseAddr'LParUndsRParUnds'SERIALIZATION'Unds'Int'Unds'String.yaml
LblisSigSCellOpt	LblisSigSCellOpt.yaml
LblisTxType	LblisTxType.yaml
Lbl'Hash'drop'LParUndsCommUndsRParUnds'EVM-TYPES'Unds'WordStack'Unds'Int'Unds'WordStack	Lbl'Hash'drop'LParUndsCommUndsRParUnds'EVM-TYPES'Unds'WordStack'Unds'Int'Unds'WordStack.yaml
Lblproject'Coln'S2KlibZModforgeZSubstdZModsrcZModmocksZModIERC721TokenReceiverMethod	Lblproject'Coln'S2KlibZModforgeZSubstdZModsrcZModmocksZModIERC721TokenReceiverMethod.yaml
Lblproject'Coln'DynamicFeeTxData'LParUndsCommUndsCommUndsCommUndsCommUndsCommUndsCommUndsCommUndsCommUndsRParUnds'EVM-TYPES'Unds'DynamicFeeTx'Unds'Int'Unds'Int'Unds'Int'Unds'Int'Unds'Account'Unds'Int'Unds'Bytes'Unds'Int'Unds'JSONs'Coln'chainId	Lblproject'Coln'DynamicFeeTxData'LParUndsCommUndsCommUndsCommUndsCommUndsCommUndsCommUndsCommUndsCommUndsRParUnds'EVM-TYPES'Unds'DynamicFeeTx'Unds'Int'Unds'Int'Unds'Int'Unds'Int'Unds'Account'Unds'Int'Unds'Bytes'Unds'Int'Unds'JSONs'Coln'chai371.yaml
LblinitExpectedOpcodeCell	LblinitExpectedOpcodeCell.yaml
LblinitExpectedEventAddressCell	LblinitExpectedEventAddressCell.yaml
LblisS2KsrcZModCounterContract	LblisS2KsrcZModCounterContract.yaml
LblisKevmCell	LblisKevmCell.yaml
LblisBlockNonceCell	LblisBlockNonceCell.yaml
Lblproject'Coln'ExpectedDataCell	Lblproject'Coln'ExpectedDataCell.yaml
LblMerkleUpdate'LParUndsCommUndsCommUndsRParUnds'SERIALIZATION'Unds'MerkleTree'Unds'MerkleTree'Unds'String'Unds'String	LblMerkleUpdate'LParUndsCommUndsCommUndsRParUnds'SERIALIZATION'Unds'MerkleTree'Unds'MerkleTree'Unds'String'Unds'String.yaml
Lbl'Hash'inStorageAux1'LParUndsCommUndsRParUnds'EVM'Unds'Bool'Unds'KItem'Unds'Int	Lbl'Hash'inStorageAux1'LParUndsCommUndsRParUnds'EVM'Unds'Bool'Unds'KItem'Unds'Int.yaml
LblisS2KlibZModforgeZSubstdZModsrcZModStdChainsContract	LblisS2KlibZModforgeZSubstdZModsrcZModStdChainsContract.yaml
Lbl'Unds-LT-Eqls'Set'UndsUnds'SET'Unds'Bool'Unds'Set'Unds'Set	Lbl'Unds-LT-Eqls'Set'UndsUnds'SET'Unds'Bool'Unds'Set'Unds'Set.yaml
LblinitNumberCell	LblinitNumberCell.yaml
Lblproject'Coln'PrevCallerCellOpt	Lblproject'Coln'PrevCallerCellOpt.yaml
Lblmethod'Unds'lib'Perc'kontrol-cheatcodes'Perc'src'Perc'KontrolCheatsBase	Lblmethod'Unds'lib'Perc'kontrol-cheatcodes'Perc'src'Perc'KontrolCheatsBase.yaml
Lblproject'Coln'EthereumCellOpt	Lblproject'Coln'EthereumCellOpt.yaml
LblisQuadStackOp	LblisQuadStackOp.yaml
Lblproject'Coln'DynamicFeeTxData'LParUndsCommUndsCommUndsCommUndsCommUndsCommUndsCommUndsCommUndsCommUndsRParUnds'EVM-TYPES'Unds'DynamicFeeTx'Unds'Int'Unds'Int'Unds'Int'Unds'Int'Unds'Account'Unds'Int'Unds'Bytes'Unds'Int'Unds'JSONs'Coln'to	Lblproject'Coln'DynamicFeeTxData'LParUndsCommUndsCommUndsCommUndsCommUndsCommUndsCommUndsCommUndsCommUndsRParUnds'EVM-TYPES'Unds'DynamicFeeTx'Unds'Int'Unds'Int'Unds'Int'Unds'Int'Unds'Account'Unds'Int'Unds'Bytes'Unds'Int'Unds'JSONs'Coln'to.yaml
LblisAcctIDCellOpt	LblisAcctIDCellOpt.yaml
Lblproject'Coln'OmmerBlockHeadersCell	Lblproject'Coln'OmmerBlockHeadersCell.yaml
Lblproject'Coln'AccountCellFragment	Lblproject'Coln'AccountCellFragment.yaml
LblisAddressSetCell	LblisAddressSetCell.yaml
Lblproject'Coln'DynamicFeeTxData'LParUndsCommUndsCommUndsCommUndsCommUndsCommUndsCommUndsCommUndsCommUndsRParUnds'EVM-TYPES'Unds'DynamicFeeTx'Unds'Int'Unds'Int'Unds'Int'Unds'Int'Unds'Account'Unds'Int'Unds'Bytes'Unds'Int'Unds'JSONs'Coln'accessLists	Lblproject'Coln'DynamicFeeTxData'LParUndsCommUndsCommUndsCommUndsCommUndsCommUndsCommUndsCommUndsCommUndsRParUnds'EVM-TYPES'Unds'DynamicFeeTx'Unds'Int'Unds'Int'Unds'Int'Unds'Int'Unds'Account'Unds'Int'Unds'Bytes'Unds'Int'Unds'JSONs'Coln'acce391.yaml
LblisTxOrderCellOpt	LblisTxOrderCellOpt.yaml
Lblproject'Coln'S2KlibZModforgeZSubstdZModsrcZModstdStorageContract	Lblproject'Coln'S2KlibZModforgeZSubstdZModsrcZModstdStorageContract.yaml
Lbl'UndsPlus'Int'Unds'	Lbl'UndsPlus'Int'Unds'.yaml
Lblproject'Coln'S2KlibZModforgeZSubstdZModsrcZModStdAssertionsContract	Lblproject'Coln'S2KlibZModforgeZSubstdZModsrcZModStdAssertionsContract.yaml
LblinitExpectedDataCell	LblinitExpectedDataCell.yaml
LblisS2KlibZModforgeZSubstdZModsrcZModmocksZModMockERC721Contract	LblisS2KlibZModforgeZSubstdZModsrcZModmocksZModMockERC721Contract.yaml
Lblproject'Coln'Exp	Lblproject'Coln'Exp.yaml
Lblproject'Coln'S2KlibZModforgeZSubstdZModsrcZModTestContract	Lblproject'Coln'S2KlibZModforgeZSubstdZModsrcZModTestContract.yaml
Lbl'Hash'isPrecompiledAccount'LParUndsCommUndsRParUnds'EVM'Unds'Bool'Unds'Int'Unds'Schedule	Lbl'Hash'isPrecompiledAccount'LParUndsCommUndsRParUnds'EVM'Unds'Bool'Unds'Int'Unds'Schedule.yaml
LblisLogCell	LblisLogCell.yaml
LblRipEmd160'LParUndsRParUnds'KRYPTO'Unds'String'Unds'String	LblRipEmd160'LParUndsRParUnds'KRYPTO'Unds'String'Unds'String.yaml
LblisMemoryUsedCell	LblisMemoryUsedCell.yaml
Lblproject'Coln'TxMaxFeeCellOpt	Lblproject'Coln'TxMaxFeeCellOpt.yaml
Lblproject'Coln'UseGasCell	Lblproject'Coln'UseGasCell.yaml
Lblproject'Coln'UnStackOp	Lblproject'Coln'UnStackOp.yaml
LblinitScheduleCell	LblinitScheduleCell.yaml
LblCnew'LParUndsCommUndsCommUndsRParUnds'GAS-FEES'Unds'Int'Unds'Schedule'Unds'Bool'Unds'Int	LblCnew'LParUndsCommUndsCommUndsRParUnds'GAS-FEES'Unds'Int'Unds'Schedule'Unds'Bool'Unds'Int.yaml
LblisEthereumSimulation	LblisEthereumSimulation.yaml
Lbl'UndsAnd-'Word'UndsUnds'EVM-TYPES'Unds'Int'Unds'Int'Unds'Int	Lbl'UndsAnd-'Word'UndsUnds'EVM-TYPES'Unds'Int'Unds'Int'Unds'Int.yaml
LblinitMemoryUsedCell	LblinitMemoryUsedCell.yaml
Lblproject'Coln'InvalidOp	Lblproject'Coln'InvalidOp.yaml
LblisRecordEventCellOpt	LblisRecordEventCellOpt.yaml
Lbl'Hash'blockHashHeaderWithdrawalsBytes	Lbl'Hash'blockHashHeaderWithdrawalsBytes.yaml
Lblproject'Coln'TxTypeCell	Lblproject'Coln'TxTypeCell.yaml
Lblbit'LParUndsCommUndsRParUnds'EVM-TYPES'Unds'Int'Unds'Int'Unds'Int	Lblbit'LParUndsCommUndsRParUnds'EVM-TYPES'Unds'Int'Unds'Int'Unds'Int.yaml
Lblproject'Coln'DynamicFeeTxData'LParUndsCommUndsCommUndsCommUndsCommUndsCommUndsCommUndsCommUndsCommUndsRParUnds'EVM-TYPES'Unds'DynamicFeeTx'Unds'Int'Unds'Int'Unds'Int'Unds'Int'Unds'Account'Unds'Int'Unds'Bytes'Unds'Int'Unds'JSONs'Coln'value	Lblproject'Coln'DynamicFeeTxData'LParUndsCommUndsCommUndsCommUndsCommUndsCommUndsCommUndsCommUndsCommUndsRParUnds'EVM-TYPES'Unds'DynamicFeeTx'Unds'Int'Unds'Int'Unds'Int'Unds'Int'Unds'Account'Unds'Int'Unds'Bytes'Unds'Int'Unds'JSONs'Coln'valu417.yaml
Lblproject'Coln'KCell	Lblproject'Coln'KCell.yaml
Lblsize'LParUndsRParUnds'LIST'Unds'Int'Unds'List	Lblsize'LParUndsRParUnds'LIST'Unds'Int'Unds'List.yaml
LblinitStatusCodeCell	LblinitStatusCodeCell.yaml
Lblproject'Coln'S2KlibZModforgeZSubstdZModsrcZModconsoleContract	Lblproject'Coln'S2KlibZModforgeZSubstdZModsrcZModconsoleContract.yaml
Lblproject'Coln'CallValueCell	Lblproject'Coln'CallValueCell.yaml
LblECDSARecover'LParUndsCommUndsCommUndsCommUndsRParUnds'KRYPTO'Unds'String'Unds'String'Unds'Int'Unds'String'Unds'String	LblECDSARecover'LParUndsCommUndsCommUndsCommUndsRParUnds'KRYPTO'Unds'String'Unds'String'Unds'Int'Unds'String'Unds'String.yaml
Lbl'Hash'unparseQuantity'LParUndsRParUnds'SERIALIZATION'Unds'String'Unds'Int	Lbl'Hash'unparseQuantity'LParUndsRParUnds'SERIALIZATION'Unds'String'Unds'Int.yaml
LblisCallDepthCell	LblisCallDepthCell.yaml
Lblproject'Coln'AccessListTxData'LParUndsCommUndsCommUndsCommUndsCommUndsCommUndsCommUndsCommUndsRParUnds'EVM-TYPES'Unds'AccessListTx'Unds'Int'Unds'Int'Unds'Int'Unds'Account'Unds'Int'Unds'Bytes'Unds'Int'Unds'JSONs'Coln'to	Lblproject'Coln'AccessListTxData'LParUndsCommUndsCommUndsCommUndsCommUndsCommUndsCommUndsCommUndsRParUnds'EVM-TYPES'Unds'AccessListTx'Unds'Int'Unds'Int'Unds'Int'Unds'Account'Unds'Int'Unds'Bytes'Unds'Int'Unds'JSONs'Coln'to.yaml
Lblproject'Coln'TimestampCellOpt	Lblproject'Coln'TimestampCellOpt.yaml
Lblproject'Coln'DepthCell	Lblproject'Coln'DepthCell.yaml
LblisBlockCell	LblisBlockCell.yaml
Lblproject'Coln'Mode	Lblproject'Coln'Mode.yaml
Lblproject'Coln'MessagesCellOpt	Lblproject'Coln'MessagesCellOpt.yaml
Lblproject'Coln'SelfDestructCellOpt	Lblproject'Coln'SelfDestructCellOpt.yaml
Lbl'Hash'signatureCallData'LParUndsCommUndsRParUnds'EVM-ABI'Unds'Bytes'Unds'String'Unds'TypedArgs	Lbl'Hash'signatureCallData'LParUndsCommUndsRParUnds'EVM-ABI'Unds'Bytes'Unds'String'Unds'TypedArgs.yaml
Lbl'Hash'rlpEncode'LParUndsRParUnds'SERIALIZATION'Unds'Bytes'Unds'JSON	Lbl'Hash'rlpEncode'LParUndsRParUnds'SERIALIZATION'Unds'Bytes'Unds'JSON.yaml
LblisMessagesCell	LblisMessagesCell.yaml
LblisS2KlibZModforgeZSubstdZModsrcZModVmContract	LblisS2KlibZModforgeZSubstdZModsrcZModVmContract.yaml
LblisGasCellOpt	LblisGasCellOpt.yaml
Lblproject'Coln'StatusCodeCellOpt	Lblproject'Coln'StatusCodeCellOpt.yaml
Lblmethod'Unds'src'Perc'Counter	Lblmethod'Unds'src'Perc'Counter.yaml
LblisToCellOpt	LblisToCellOpt.yaml
Lblproject'Coln'ScheduleConst	Lblproject'Coln'ScheduleConst.yaml
LblblockHeaderHashWithdrawals	LblblockHeaderHashWithdrawals.yaml
Lblproject'Coln'CallValueCellOpt	Lblproject'Coln'CallValueCellOpt.yaml
Lblproject'Coln'Signedness	Lblproject'Coln'Signedness.yaml
Lbl'Unds'impliesBool'Unds'	Lbl'Unds'impliesBool'Unds'.yaml
Lbl'Stop'List	Lbl'Stop'List.yaml
LblSet2List'LParUndsRParUnds'COLLECTIONS'Unds'List'Unds'Set	LblSet2List'LParUndsRParUnds'COLLECTIONS'Unds'List'Unds'Set.yaml
Lblproject'Coln'S2KlibZModforgeZSubstdZModsrcZModstdJsonContract	Lblproject'Coln'S2KlibZModforgeZSubstdZModsrcZModstdJsonContract.yaml
Lblword2Bool'LParUndsRParUnds'EVM-TYPES'Unds'Bool'Unds'Int	Lblword2Bool'LParUndsRParUnds'EVM-TYPES'Unds'Bool'Unds'Int.yaml
LblinitCallValueCell	LblinitCallValueCell.yaml
LblinitCallDepthCell	LblinitCallDepthCell.yaml
LblisSigSCell	LblisSigSCell.yaml
Lbl'Unds-LT-'Gas'UndsUnds'GAS-SYNTAX'Unds'Bool'Unds'Gas'Unds'Gas	Lbl'Unds-LT-'Gas'UndsUnds'GAS-SYNTAX'Unds'Bool'Unds'Gas'Unds'Gas.yaml
LblisSchedule	LblisSchedule.yaml
LblisCodeCellOpt	LblisCodeCellOpt.yaml
LblisS2KlibZModforgeZSubstdZModsrcZModstdMathContract	LblisS2KlibZModforgeZSubstdZModsrcZModstdMathContract.yaml
LblisPrankCellFragment	LblisPrankCellFragment.yaml
Lblproject'Coln'S2KlibZModforgeZSubstdZModsrcZModStdAssertionsMethod	Lblproject'Coln'S2KlibZModforgeZSubstdZModsrcZModStdAssertionsMethod.yaml
LblisWordStackCellOpt	LblisWordStackCellOpt.yaml
LblinitCallStateCell	LblinitCallStateCell.yaml
Lblproject'Coln'ExpectedDataCellOpt	Lblproject'Coln'ExpectedDataCellOpt.yaml
LblisRefundCell	LblisRefundCell.yaml
Lbl'Hash'alignHexString'LParUndsRParUnds'SERIALIZATION'Unds'String'Unds'String	Lbl'Hash'alignHexString'LParUndsRParUnds'SERIALIZATION'Unds'String'Unds'String.yaml
LblRsstore'LParUndsCommUndsCommUndsCommUndsRParUnds'GAS-FEES'Unds'Int'Unds'Schedule'Unds'Int'Unds'Int'Unds'Int	LblRsstore'LParUndsCommUndsCommUndsCommUndsRParUnds'GAS-FEES'Unds'Int'Unds'Schedule'Unds'Int'Unds'Int'Unds'Int.yaml
Lbl'Unds-LT-Unds-GT-Unds'SCHEDULE'Unds'Int'Unds'ScheduleConst'Unds'Schedule	Lbl'Unds-LT-Unds-GT-Unds'SCHEDULE'Unds'Int'Unds'ScheduleConst'Unds'Schedule.yaml
LblisS2KlibZModforgeZSubstdZModsrcZModStdStyleContract	LblisS2KlibZModforgeZSubstdZModsrcZModStdStyleContract.yaml
LblmaxInt'LParUndsCommUndsRParUnds'INT-COMMON'Unds'Int'Unds'Int'Unds'Int	LblmaxInt'LParUndsCommUndsRParUnds'INT-COMMON'Unds'Int'Unds'Int'Unds'Int.yaml
Lblproject'Coln'CheatcodesCellFragment	Lblproject'Coln'CheatcodesCellFragment.yaml
Lbl'Hash'addrFromPrivateKey'LParUndsRParUnds'SERIALIZATION'Unds'Int'Unds'String	Lbl'Hash'addrFromPrivateKey'LParUndsRParUnds'SERIALIZATION'Unds'Int'Unds'String.yaml
LblrfindString'LParUndsCommUndsCommUndsRParUnds'STRING-COMMON'Unds'Int'Unds'String'Unds'String'Unds'Int	LblrfindString'LParUndsCommUndsCommUndsRParUnds'STRING-COMMON'Unds'Int'Unds'String'Unds'String'Unds'Int.yaml
LblisAccountsCellFragment	LblisAccountsCellFragment.yaml
LblisCodeCell	LblisCodeCell.yaml
Lblproject'Coln'S2KtestZModCounterTestContract	Lblproject'Coln'S2KtestZModCounterTestContract.yaml
LblisCoinbaseCell	LblisCoinbaseCell.yaml
LblString2Base'LParUndsCommUndsRParUnds'STRING-COMMON'Unds'Int'Unds'String'Unds'Int	LblString2Base'LParUndsCommUndsRParUnds'STRING-COMMON'Unds'Int'Unds'String'Unds'Int.yaml
LblsortedJSONs'LParUndsRParUnds'JSON-EXT'Unds'Bool'Unds'JSONs	LblsortedJSONs'LParUndsRParUnds'JSON-EXT'Unds'Bool'Unds'JSONs.yaml
Lbl'Hash'encodeArgs'LParUndsRParUnds'EVM-ABI'Unds'Bytes'Unds'TypedArgs	Lbl'Hash'encodeArgs'LParUndsRParUnds'EVM-ABI'Unds'Bytes'Unds'TypedArgs.yaml
Lbl'Hash'sizeOfDynamicType'LParUndsRParUnds'EVM-ABI'Unds'Int'Unds'TypedArg	Lbl'Hash'sizeOfDynamicType'LParUndsRParUnds'EVM-ABI'Unds'Int'Unds'TypedArg.yaml
LblisS2KlibZModforgeZSubstdZModsrcZModStdCheatsContract	LblisS2KlibZModforgeZSubstdZModsrcZModStdCheatsContract.yaml
LblisS2KlibZModforgeZSubstdZModsrcZModTestMethod	LblisS2KlibZModforgeZSubstdZModsrcZModTestMethod.yaml
Lblgas2Int'LParUndsRParUnds'GAS-SYNTAX'Unds'Int'Unds'Gas	Lblgas2Int'LParUndsRParUnds'GAS-SYNTAX'Unds'Int'Unds'Gas.yaml
Lblproject'Coln'NetworkCellFragment	Lblproject'Coln'NetworkCellFragment.yaml
LblisS2KlibZModkontrolZSubcheatcodesZModsrcZModKontrolCheatsMethod	LblisS2KlibZModkontrolZSubcheatcodesZModsrcZModKontrolCheatsMethod.yaml
LblStringBuffer2String'LParUndsRParUnds'STRING-BUFFER-HOOKED'Unds'String'Unds'StringBuffer	LblStringBuffer2String'LParUndsRParUnds'STRING-BUFFER-HOOKED'Unds'String'Unds'StringBuffer.yaml
LblisIsRevertExpectedCellOpt	LblisIsRevertExpectedCellOpt.yaml
Lblproject'Coln'CheckedDataCell	Lblproject'Coln'CheckedDataCell.yaml
Lblproject'Coln'WithdrawalsRootCellOpt	Lblproject'Coln'WithdrawalsRootCellOpt.yaml
Lblproject'Coln'FoundryCell	Lblproject'Coln'FoundryCell.yaml
LblinitSigVCell	LblinitSigVCell.yaml
Lblproject'Coln'S2KlibZModforgeZSubstdZModlibZModdsZSubtestZModsrcZModDSTestMethod	Lblproject'Coln'S2KlibZModforgeZSubstdZModlibZModdsZSubtestZModsrcZModDSTestMethod.yaml
Lblproject'Coln'LegacyTxData'LParUndsCommUndsCommUndsCommUndsCommUndsCommUndsRParUnds'EVM-TYPES'Unds'LegacyTx'Unds'Int'Unds'Int'Unds'Int'Unds'Account'Unds'Int'Unds'Bytes'Coln'gasPrice	Lblproject'Coln'LegacyTxData'LParUndsCommUndsCommUndsCommUndsCommUndsCommUndsRParUnds'EVM-TYPES'Unds'LegacyTx'Unds'Int'Unds'Int'Unds'Int'Unds'Account'Unds'Int'Unds'Bytes'Coln'gasPrice.yaml
Lblproject'Coln'S2KlibZModforgeZSubstdZModsrcZModinterfacesZModIMulticall3Contract	Lblproject'Coln'S2KlibZModforgeZSubstdZModsrcZModinterfacesZModIMulticall3Contract.yaml
LblinitBlockNonceCell	LblinitBlockNonceCell.yaml
Lbl'Hash'encodeArgsAux'LParUndsCommUndsCommUndsCommUndsRParUnds'EVM-ABI'Unds'Bytes'Unds'TypedArgs'Unds'Int'Unds'Bytes'Unds'Bytes	Lbl'Hash'encodeArgsAux'LParUndsCommUndsCommUndsCommUndsRParUnds'EVM-ABI'Unds'Bytes'Unds'TypedArgs'Unds'Int'Unds'Bytes'Unds'Bytes.yaml
LblinitGasCell	LblinitGasCell.yaml
Lbl'UndsEqlsSlshEqls'String'UndsUnds'STRING-COMMON'Unds'Bool'Unds'String'Unds'String	Lbl'UndsEqlsSlshEqls'String'UndsUnds'STRING-COMMON'Unds'Bool'Unds'String'Unds'String.yaml
LblisExpectedRevertCellFragment	LblisExpectedRevertCellFragment.yaml
LblisBinStackOp	LblisBinStackOp.yaml
Lblproject'Coln'AccessListTxData'LParUndsCommUndsCommUndsCommUndsCommUndsCommUndsCommUndsCommUndsRParUnds'EVM-TYPES'Unds'AccessListTx'Unds'Int'Unds'Int'Unds'Int'Unds'Account'Unds'Int'Unds'Bytes'Unds'Int'Unds'JSONs'Coln'value	Lblproject'Coln'AccessListTxData'LParUndsCommUndsCommUndsCommUndsCommUndsCommUndsCommUndsCommUndsRParUnds'EVM-TYPES'Unds'AccessListTx'Unds'Int'Unds'Int'Unds'Int'Unds'Account'Unds'Int'Unds'Bytes'Unds'Int'Unds'JSONs'Coln'value.yaml
LblAccountCellMapItem	LblAccountCellMapItem.yaml
Lblproject'Coln'TxAccessCellOpt	Lblproject'Coln'TxAccessCellOpt.yaml
Lblproject'Coln'S2KlibZModforgeZSubstdZModsrcZModStdInvariantContract	Lblproject'Coln'S2KlibZModforgeZSubstdZModsrcZModStdInvariantContract.yaml
LblisS2KlibZModforgeZSubstdZModsrcZModTestBaseContract	LblisS2KlibZModforgeZSubstdZModsrcZModTestBaseContract.yaml
Lblproject'Coln'Int	Lblproject'Coln'Int.yaml
Lblproject'Coln'ChainIDCellOpt	Lblproject'Coln'ChainIDCellOpt.yaml
Lbl'Hash'sender'LParUndsCommUndsCommUndsCommUndsRParUnds'SERIALIZATION'Unds'Account'Unds'Bytes'Unds'Int'Unds'Bytes'Unds'Bytes	Lbl'Hash'sender'LParUndsCommUndsCommUndsCommUndsRParUnds'SERIALIZATION'Unds'Account'Unds'Bytes'Unds'Int'Unds'Bytes'Unds'Bytes.yaml
Lblproject'Coln'JumpDestsCell	Lblproject'Coln'JumpDestsCell.yaml
Lbl'UndsStar'Int'Unds'	Lbl'UndsStar'Int'Unds'.yaml
Lbl'Unds'-Map'UndsUnds'MAP'Unds'Map'Unds'Map'Unds'Map	Lbl'Unds'-Map'UndsUnds'MAP'Unds'Map'Unds'Map'Unds'Map.yaml
LblBool2String'LParUndsRParUnds'STRING-COMMON'Unds'String'Unds'Bool	LblBool2String'LParUndsRParUnds'STRING-COMMON'Unds'String'Unds'Bool.yaml
Lbl'Hash'rlpEncodeLogs'LParUndsRParUnds'SERIALIZATION'Unds'Bytes'Unds'List	Lbl'Hash'rlpEncodeLogs'LParUndsRParUnds'SERIALIZATION'Unds'Bytes'Unds'List.yaml
Lbl'Hash'memoryUsageUpdate'LParUndsCommUndsCommUndsRParUnds'EVM'Unds'Int'Unds'Int'Unds'Int'Unds'Int	Lbl'Hash'memoryUsageUpdate'LParUndsCommUndsCommUndsRParUnds'EVM'Unds'Int'Unds'Int'Unds'Int'Unds'Int.yaml
Lblproject'Coln'MemoryUsedCellOpt	Lblproject'Coln'MemoryUsedCellOpt.yaml
Lbl'Unds'divInt'Unds'	Lbl'Unds'divInt'Unds'.yaml
Lblproject'Coln'NewCallerCell	Lblproject'Coln'NewCallerCell.yaml
Lblproject'Coln'EthereumCell	Lblproject'Coln'EthereumCell.yaml
Lbl'Hash'decodeLengthPrefixLength'LParUndsCommUndsCommUndsCommUndsRParUnds'SERIALIZATION'Unds'LengthPrefix'Unds'LengthPrefixType'Unds'Int'Unds'Int'Unds'Int	Lbl'Hash'decodeLengthPrefixLength'LParUndsCommUndsCommUndsCommUndsRParUnds'SERIALIZATION'Unds'LengthPrefix'Unds'LengthPrefixType'Unds'Int'Unds'Int'Unds'Int.yaml
LblinitNonceCell	LblinitNonceCell.yaml
LblrfindChar'LParUndsCommUndsCommUndsRParUnds'STRING-COMMON'Unds'Int'Unds'String'Unds'String'Unds'Int	LblrfindChar'LParUndsCommUndsCommUndsRParUnds'STRING-COMMON'Unds'Int'Unds'String'Unds'String'Unds'Int.yaml
Lblproject'Coln'AcctIDCell	Lblproject'Coln'AcctIDCell.yaml
Lblproject'Coln'MaybeOpCode	Lblproject'Coln'MaybeOpCode.yaml
LblisS2KsrcZModCounterMethod	LblisS2KsrcZModCounterMethod.yaml
LblisExpectedOpcodeCellOpt	LblisExpectedOpcodeCellOpt.yaml
Lbl'Hash'encBytes'LParUndsCommUndsRParUnds'EVM-ABI'Unds'Bytes'Unds'Int'Unds'Bytes	Lbl'Hash'encBytes'LParUndsCommUndsRParUnds'EVM-ABI'Unds'Bytes'Unds'Int'Unds'Bytes.yaml
Lblfoundry'Unds'success	Lblfoundry'Unds'success.yaml
LblisOmmerBlockHeadersCell	LblisOmmerBlockHeadersCell.yaml
Lbl'UndsLSqBUndsColnEqlsUndsRSqBUnds'EVM-TYPES'Unds'WordStack'Unds'WordStack'Unds'Int'Unds'Int	Lbl'UndsLSqBUndsColnEqlsUndsRSqBUnds'EVM-TYPES'Unds'WordStack'Unds'WordStack'Unds'Int'Unds'Int.yaml
LblisK	LblisK.yaml
LblBlake2Compress'LParUndsRParUnds'KRYPTO'Unds'String'Unds'String	LblBlake2Compress'LParUndsRParUnds'KRYPTO'Unds'String'Unds'String.yaml
LblisWordStackCell	LblisWordStackCell.yaml
LblMessageCellMap'Coln'in'Unds'keys	LblMessageCellMap'Coln'in'Unds'keys.yaml
LblisExpectedDepthCell	LblisExpectedDepthCell.yaml
LblinitExitCodeCell	LblinitExitCodeCell.yaml
Lbl'Stop'MessageCellMap	Lbl'Stop'MessageCellMap.yaml
LblisGeneratedTopCell	LblisGeneratedTopCell.yaml
Lblproject'Coln'S2KlibZModforgeZSubstdZModsrcZModsafeconsoleContract	Lblproject'Coln'S2KlibZModforgeZSubstdZModsrcZModsafeconsoleContract.yaml
LblisS2KlibZModforgeZSubstdZModsrcZModstdJsonContract	LblisS2KlibZModforgeZSubstdZModsrcZModstdJsonContract.yaml
LblisOutputCellOpt	LblisOutputCellOpt.yaml
Lbl'UndsAnd-'Int'Unds'	Lbl'UndsAnd-'Int'Unds'.yaml
Lblproject'Coln'SigSCell	Lblproject'Coln'SigSCell.yaml
LblisS2KlibZModforgeZSubstdZModsrcZModinterfacesZModIMulticall3Contract	LblisS2KlibZModforgeZSubstdZModsrcZModinterfacesZModIMulticall3Contract.yaml
Lblreplace'LParUndsCommUndsCommUndsCommUndsRParUnds'STRING-COMMON'Unds'String'Unds'String'Unds'String'Unds'String'Unds'Int	Lblreplace'LParUndsCommUndsCommUndsCommUndsRParUnds'STRING-COMMON'Unds'String'Unds'String'Unds'String'Unds'String'Unds'Int.yaml
LblisExpectedValueCell	LblisExpectedValueCell.yaml
LblisGasPriceCell	LblisGasPriceCell.yaml
LblisCheckedTopicsCellOpt	LblisCheckedTopicsCellOpt.yaml
Lblproject'Coln'S2KlibZModforgeZSubstdZModsrcZModstdStorageSafeContract	Lblproject'Coln'S2KlibZModforgeZSubstdZModsrcZModstdStorageSafeContract.yaml
Lbl'Hash'if'UndsHash'then'UndsHash'else'UndsHash'fi'Unds'K-EQUAL-SYNTAX'Unds'Sort'Unds'Bool'Unds'Sort'Unds'Sort	Lbl'Hash'if'UndsHash'then'UndsHash'else'UndsHash'fi'Unds'K-EQUAL-SYNTAX'Unds'Sort'Unds'Bool'Unds'Sort'Unds'Sort.yaml
Lblbyte'LParUndsCommUndsRParUnds'EVM-TYPES'Unds'Int'Unds'Int'Unds'Int	Lblbyte'LParUndsCommUndsRParUnds'EVM-TYPES'Unds'Int'Unds'Int'Unds'Int.yaml
Lbl'Hash'if'UndsHash'then'UndsHash'else'UndsHash'fi'Unds'K-EQUAL-SYNTAX'Unds'Sort'Unds'Bool'Unds'Sort'Unds'Sort	Lbl'Hash'if'UndsHash'then'UndsHash'else'UndsHash'fi'Unds'K-EQUAL-SYNTAX'Unds'Sort'Unds'Bool'Unds'Sort'Unds'Sort.yaml
LblString2Int'LParUndsRParUnds'STRING-COMMON'Unds'Int'Unds'String	LblString2Int'LParUndsRParUnds'STRING-COMMON'Unds'Int'Unds'String.yaml
Lbl'Unds'in'UndsUnds'EVM-TYPES'Unds'Bool'Unds'Int'Unds'WordStack	Lbl'Unds'in'UndsUnds'EVM-TYPES'Unds'Bool'Unds'Int'Unds'WordStack.yaml
Lbl'UndsEqlsEqls'Bool'Unds'	Lbl'UndsEqlsEqls'Bool'Unds'.yaml
Lblproject'Coln'IsOpcodeExpectedCellOpt	Lblproject'Coln'IsOpcodeExpectedCellOpt.yaml
Lblproject'Coln'S2KlibZModforgeZSubstdZModsrcZModVmContract	Lblproject'Coln'S2KlibZModforgeZSubstdZModsrcZModVmContract.yaml
LblWordStack2List'LParUndsRParUnds'EVM-TYPES'Unds'List'Unds'WordStack	LblWordStack2List'LParUndsRParUnds'EVM-TYPES'Unds'List'Unds'WordStack.yaml
LblisS2KlibZModforgeZSubstdZModsrcZModStdAssertionsContract	LblisS2KlibZModforgeZSubstdZModsrcZModStdAssertionsContract.yaml
Lblproject'Coln'TxPendingCellOpt	Lblproject'Coln'TxPendingCellOpt.yaml
LblisCallGasCellOpt	LblisCallGasCellOpt.yaml
Lblproject'Coln'ExpectedAddressCell	Lblproject'Coln'ExpectedAddressCell.yaml
LblinitCallGasCell	LblinitCallGasCell.yaml
Lblproject'Coln'DynamicFeeTxData'LParUndsCommUndsCommUndsCommUndsCommUndsCommUndsCommUndsCommUndsCommUndsRParUnds'EVM-TYPES'Unds'DynamicFeeTx'Unds'Int'Unds'Int'Unds'Int'Unds'Int'Unds'Account'Unds'Int'Unds'Bytes'Unds'Int'Unds'JSONs'Coln'priorityGasFee	Lblproject'Coln'DynamicFeeTxData'LParUndsCommUndsCommUndsCommUndsCommUndsCommUndsCommUndsCommUndsCommUndsRParUnds'EVM-TYPES'Unds'DynamicFeeTx'Unds'Int'Unds'Int'Unds'Int'Unds'Int'Unds'Account'Unds'Int'Unds'Bytes'Unds'Int'Unds'JSONs'Coln'prio538.yaml
LblinitTouchedAccountsCell	LblinitTouchedAccountsCell.yaml
Lblproject'Coln'JSONKey	Lblproject'Coln'JSONKey.yaml
Lblproject'Coln'S2KlibZModforgeZSubstdZModsrcZModScriptBaseContract	Lblproject'Coln'S2KlibZModforgeZSubstdZModsrcZModScriptBaseContract.yaml
Lbl'UndsLSqBUndsColnEqlsUndsRSqBUnds'EVM-TYPES'Unds'Bytes'Unds'Bytes'Unds'Int'Unds'Bytes	Lbl'UndsLSqBUndsColnEqlsUndsRSqBUnds'EVM-TYPES'Unds'Bytes'Unds'Bytes'Unds'Int'Unds'Bytes.yaml
Lbl'Hash'adjustedExpLength'LParUndsCommUndsCommUndsRParUnds'GAS-FEES'Unds'Int'Unds'Int'Unds'Int'Unds'Bytes	Lbl'Hash'adjustedExpLength'LParUndsCommUndsCommUndsRParUnds'GAS-FEES'Unds'Int'Unds'Int'Unds'Int'Unds'Bytes.yaml
LblSet'Coln'difference	LblSet'Coln'difference.yaml
Lbl'UndsEqlsEqls'Int'Unds'	Lbl'UndsEqlsEqls'Int'Unds'.yaml
LblisTxGasLimitCellOpt	LblisTxGasLimitCellOpt.yaml
Lbl'Unds'Set'Unds'	Lbl'Unds'Set'Unds'.yaml
Lblproject'Coln'JSONs	Lblproject'Coln'JSONs.yaml
Lbl'Unds-LT-Eqls'Gas'UndsUnds'GAS-SYNTAX'Unds'Bool'Unds'Gas'Unds'Gas	Lbl'Unds-LT-Eqls'Gas'UndsUnds'GAS-SYNTAX'Unds'Bool'Unds'Gas'Unds'Gas.yaml
LblG'StarLParUndsCommUndsCommUndsCommUndsRParUnds'GAS-FEES'Unds'Gas'Unds'Gas'Unds'Int'Unds'Int'Unds'Schedule	LblG'StarLParUndsCommUndsCommUndsCommUndsRParUnds'GAS-FEES'Unds'Gas'Unds'Gas'Unds'Int'Unds'Int'Unds'Schedule.yaml
Lblproject'Coln'WhitelistCell	Lblproject'Coln'WhitelistCell.yaml
Lblproject'Coln'DynamicFeeTxData'LParUndsCommUndsCommUndsCommUndsCommUndsCommUndsCommUndsCommUndsCommUndsRParUnds'EVM-TYPES'Unds'DynamicFeeTx'Unds'Int'Unds'Int'Unds'Int'Unds'Int'Unds'Account'Unds'Int'Unds'Bytes'Unds'Int'Unds'JSONs'Coln'gasLimit	Lblproject'Coln'DynamicFeeTxData'LParUndsCommUndsCommUndsCommUndsCommUndsCommUndsCommUndsCommUndsCommUndsRParUnds'EVM-TYPES'Unds'DynamicFeeTx'Unds'Int'Unds'Int'Unds'Int'Unds'Int'Unds'Account'Unds'Int'Unds'Bytes'Unds'Int'Unds'JSONs'Coln'gasL562.yaml
LblfindString'LParUndsCommUndsCommUndsRParUnds'STRING-COMMON'Unds'Int'Unds'String'Unds'String'Unds'Int	LblfindString'LParUndsCommUndsCommUndsRParUnds'STRING-COMMON'Unds'Int'Unds'String'Unds'String'Unds'Int.yaml
Lblproject'Coln'AccessedStorageCellOpt	Lblproject'Coln'AccessedStorageCellOpt.yaml
Lbl'Hash'precompiledAccounts'LParUndsRParUnds'EVM'Unds'Set'Unds'Schedule	Lbl'Hash'precompiledAccounts'LParUndsRParUnds'EVM'Unds'Set'Unds'Schedule.yaml
Lbl'UndsPipe'Int'Unds'	Lbl'UndsPipe'Int'Unds'.yaml
Lbl'UndsEqlsEqls'String'UndsUnds'STRING-COMMON'Unds'Bool'Unds'String'Unds'String	Lbl'UndsEqlsEqls'String'UndsUnds'STRING-COMMON'Unds'Bool'Unds'String'Unds'String.yaml
LblisPrankCell	LblisPrankCell.yaml
Lblproject'Coln'GasCell	Lblproject'Coln'GasCell.yaml
Lbl'Stop'StringBuffer'Unds'STRING-BUFFER-HOOKED'Unds'StringBuffer	Lbl'Stop'StringBuffer'Unds'STRING-BUFFER-HOOKED'Unds'StringBuffer.yaml
Lbl'Hash'getIndexedArgs'LParUndsRParUnds'EVM-ABI'Unds'List'Unds'EventArgs	Lbl'Hash'getIndexedArgs'LParUndsRParUnds'EVM-ABI'Unds'List'Unds'EventArgs.yaml
Lbl'Hash'rlpDecodeList'LParUndsCommUndsRParUnds'SERIALIZATION'Unds'JSONs'Unds'Bytes'Unds'Int	Lbl'Hash'rlpDecodeList'LParUndsCommUndsRParUnds'SERIALIZATION'Unds'JSONs'Unds'Bytes'Unds'Int.yaml
Lblproject'Coln'MessageCellFragment	Lblproject'Coln'MessageCellFragment.yaml
Lbl'Hash'ecrec'LParUndsRParUnds'EVM'Unds'Bytes'Unds'Account	Lbl'Hash'ecrec'LParUndsRParUnds'EVM'Unds'Bytes'Unds'Account.yaml
Lblproject'Coln'MerkleTree	Lblproject'Coln'MerkleTree.yaml
Lbl'Unds'in'Unds'keys'LParUndsRParUnds'MAP'Unds'Bool'Unds'KItem'Unds'Map	Lbl'Unds'in'Unds'keys'LParUndsRParUnds'MAP'Unds'Bool'Unds'KItem'Unds'Map.yaml
LblminGas'LParUndsCommUndsRParUnds'GAS-SYNTAX'Unds'Gas'Unds'Gas'Unds'Gas	LblminGas'LParUndsCommUndsRParUnds'GAS-SYNTAX'Unds'Gas'Unds'Gas'Unds'Gas.yaml
Lbl'Unds'xorWord'UndsUnds'EVM-TYPES'Unds'Int'Unds'Int'Unds'Int	Lbl'Unds'xorWord'UndsUnds'EVM-TYPES'Unds'Int'Unds'Int'Unds'Int.yaml
LblintersectSet'LParUndsCommUndsRParUnds'SET'Unds'Set'Unds'Set'Unds'Set	LblintersectSet'LParUndsCommUndsRParUnds'SET'Unds'Set'Unds'Set'Unds'Set.yaml
LblinitSubstateCell	LblinitSubstateCell.yaml
Lblproject'Coln'IsOpcodeExpectedCell	Lblproject'Coln'IsOpcodeExpectedCell.yaml
Lblproject'Coln'S2KscriptZModCounterScriptContract	Lblproject'Coln'S2KscriptZModCounterScriptContract.yaml
Lbl'Hash'parseHexBytes'LParUndsRParUnds'SERIALIZATION'Unds'Bytes'Unds'String	Lbl'Hash'parseHexBytes'LParUndsRParUnds'SERIALIZATION'Unds'Bytes'Unds'String.yaml
Lblproject'Coln'CallDepthCell	Lblproject'Coln'CallDepthCell.yaml
Lblproject'Coln'ReceiptsRootCell	Lblproject'Coln'ReceiptsRootCell.yaml
Lbl'Hash'modexp4'LParUndsCommUndsCommUndsRParUnds'EVM'Unds'Bytes'Unds'Int'Unds'Int'Unds'Int	Lbl'Hash'modexp4'LParUndsCommUndsCommUndsRParUnds'EVM'Unds'Bytes'Unds'Int'Unds'Int'Unds'Int.yaml
Lbl'Hash'stackAdded'LParUndsRParUnds'EVM'Unds'Int'Unds'OpCode	Lbl'Hash'stackAdded'LParUndsRParUnds'EVM'Unds'Int'Unds'OpCode.yaml
LblisS2KlibZModforgeZSubstdZModsrcZModconsole2Contract	LblisS2KlibZModforgeZSubstdZModsrcZModconsole2Contract.yaml
LblisBlockhashesCell	LblisBlockhashesCell.yaml
Lbl'Unds-GT--GT-'Byte'UndsUnds'WORD'Unds'Int'Unds'Int'Unds'Int	Lbl'Unds-GT--GT-'Byte'UndsUnds'WORD'Unds'Int'Unds'Int'Unds'Int.yaml
Lblproject'Coln'ExtraDataCellOpt	Lblproject'Coln'ExtraDataCellOpt.yaml
Lblproject'Coln'MemoryUsedCell	Lblproject'Coln'MemoryUsedCell.yaml
Lbl'UndsEqlsEqls'K'Unds'	Lbl'UndsEqlsEqls'K'Unds'.yaml
LblisG1Point	LblisG1Point.yaml
LblisJumpDestsCell	LblisJumpDestsCell.yaml
Lblproject'Coln'S2KsrcZModCounterMethod	Lblproject'Coln'S2KsrcZModCounterMethod.yaml
Lblbool2Word'LParUndsRParUnds'EVM-TYPES'Unds'Int'Unds'Bool	Lblbool2Word'LParUndsRParUnds'EVM-TYPES'Unds'Int'Unds'Bool.yaml
LblKeccak256'LParUndsRParUnds'KRYPTO'Unds'String'Unds'String	LblKeccak256'LParUndsRParUnds'KRYPTO'Unds'String'Unds'String.yaml
Lblproject'Coln'PreviousHashCell	Lblproject'Coln'PreviousHashCell.yaml
LblisExpectedEventAddressCellOpt	LblisExpectedEventAddressCellOpt.yaml
Lblproject'Coln'IntList	Lblproject'Coln'IntList.yaml
Lblproject'Coln'AccountsCellFragment	Lblproject'Coln'AccountsCellFragment.yaml
Lbl'Unds'modInt'Unds'	Lbl'Unds'modInt'Unds'.yaml
LblisS2KlibZModforgeZSubstdZModsrcZModconsoleContract	LblisS2KlibZModforgeZSubstdZModsrcZModconsoleContract.yaml
LblisG2Point	LblisG2Point.yaml
LblCmem'LParUndsCommUndsRParUnds'GAS-FEES'Unds'Int'Unds'Schedule'Unds'Int	LblCmem'LParUndsCommUndsRParUnds'GAS-FEES'Unds'Int'Unds'Schedule'Unds'Int.yaml
LblisAddr1Op'LParUndsRParUnds'EVM'Unds'Bool'Unds'OpCode	LblisAddr1Op'LParUndsRParUnds'EVM'Unds'Bool'Unds'OpCode.yaml
LblisS2KlibZModforgeZSubstdZModsrcZModstdErrorContract	LblisS2KlibZModforgeZSubstdZModsrcZModstdErrorContract.yaml
Lbl'Hash'rlpEncodeTopics'LParUndsCommUndsRParUnds'SERIALIZATION'Unds'Bytes'Unds'List'Unds'StringBuffer	Lbl'Hash'rlpEncodeTopics'LParUndsCommUndsRParUnds'SERIALIZATION'Unds'Bytes'Unds'List'Unds'StringBuffer.yaml
LblinitMixHashCell	LblinitMixHashCell.yaml
Lbl'Hash'usesAccessList'LParUndsRParUnds'EVM'Unds'Bool'Unds'OpCode	Lbl'Hash'usesAccessList'LParUndsRParUnds'EVM'Unds'Bool'Unds'OpCode.yaml
LblisRecordEventCell	LblisRecordEventCell.yaml
LblisDifficultyCellOpt	LblisDifficultyCellOpt.yaml
Lbl'Hash'asAccount'LParUndsRParUnds'EVM-TYPES'Unds'Account'Unds'Bytes	Lbl'Hash'asAccount'LParUndsRParUnds'EVM-TYPES'Unds'Account'Unds'Bytes.yaml
LblinitMessagesCell	LblinitMessagesCell.yaml
Lblproject'Coln'TxPriorityFeeCellOpt	Lblproject'Coln'TxPriorityFeeCellOpt.yaml
LblisTxPendingCell	LblisTxPendingCell.yaml
LblisEndStatusCode	LblisEndStatusCode.yaml
LblisReceiptsRootCell	LblisReceiptsRootCell.yaml
LblList2Set'LParUndsRParUnds'COLLECTIONS'Unds'Set'Unds'List	LblList2Set'LParUndsRParUnds'COLLECTIONS'Unds'Set'Unds'List.yaml
Lbl'Unds-LT-'Int'Unds'	Lbl'Unds-LT-'Int'Unds'.yaml
Lblproject'Coln'GasUsedCellOpt	Lblproject'Coln'GasUsedCellOpt.yaml
Lblproject'Coln'S2KlibZModforgeZSubstdZModsrcZModStdCheatsSafeContract	Lblproject'Coln'S2KlibZModforgeZSubstdZModsrcZModStdCheatsSafeContract.yaml
LblCgascap'LParUndsCommUndsCommUndsCommUndsRParUnds'GAS-FEES'Unds'Gas'Unds'Schedule'Unds'Gas'Unds'Gas'Unds'Int	LblCgascap'LParUndsCommUndsCommUndsCommUndsRParUnds'GAS-FEES'Unds'Gas'Unds'Schedule'Unds'Gas'Unds'Gas'Unds'Int.yaml
LblisValidPoint'LParUndsRParUnds'KRYPTO'Unds'Bool'Unds'G1Point	LblisValidPoint'LParUndsRParUnds'KRYPTO'Unds'Bool'Unds'G1Point.yaml
LblisExp	LblisExp.yaml
LblisEndianness	LblisEndianness.yaml
LblisMessageCellMap	LblisMessageCellMap.yaml
Lbl'Hash'matchReason'LParUndsCommUndsRParUnds'FOUNDRY-CHEAT-CODES'Unds'Bool'Unds'Bytes'Unds'Bytes	Lbl'Hash'matchReason'LParUndsCommUndsRParUnds'FOUNDRY-CHEAT-CODES'Unds'Bool'Unds'Bytes'Unds'Bytes.yaml
Lbl'Hash'parseAccessListStorageKeys'LParUndsRParUnds'SERIALIZATION'Unds'List'Unds'JSONs	Lbl'Hash'parseAccessListStorageKeys'LParUndsRParUnds'SERIALIZATION'Unds'List'Unds'JSONs.yaml
LblisS2KlibZModforgeZSubstdZModsrcZModStdInvariantContract	LblisS2KlibZModforgeZSubstdZModsrcZModStdInvariantContract.yaml
Lbl'Hash'rlpEncodeLogsAux'LParUndsCommUndsRParUnds'SERIALIZATION'Unds'Bytes'Unds'List'Unds'StringBuffer	Lbl'Hash'rlpEncodeLogsAux'LParUndsCommUndsRParUnds'SERIALIZATION'Unds'Bytes'Unds'List'Unds'StringBuffer.yaml
LblisLogOp	LblisLogOp.yaml
Lbl'UndsPlus'String'UndsUnds'STRING-BUFFER-HOOKED'Unds'StringBuffer'Unds'StringBuffer'Unds'String	Lbl'UndsPlus'String'UndsUnds'STRING-BUFFER-HOOKED'Unds'StringBuffer'Unds'StringBuffer'Unds'String.yaml
Lblproject'Coln'CheckedDataCellOpt	Lblproject'Coln'CheckedDataCellOpt.yaml
Lbl'Unds'Map'Unds'	Lbl'Unds'Map'Unds'.yaml
Lblproject'Coln'EthereumCommand	Lblproject'Coln'EthereumCommand.yaml
Lblsize'LParUndsRParUnds'SET'Unds'Int'Unds'Set	Lblsize'LParUndsRParUnds'SET'Unds'Int'Unds'Set.yaml
LblisS2KlibZModforgeZSubstdZModsrcZModinterfacesZModIMulticall3Method	LblisS2KlibZModforgeZSubstdZModsrcZModinterfacesZModIMulticall3Method.yaml
Lblproject'Coln'ValueCellOpt	Lblproject'Coln'ValueCellOpt.yaml
Lblproject'Coln'ExpectEmitCellFragment	Lblproject'Coln'ExpectEmitCellFragment.yaml
LblisGeneratedTopCellFragment	LblisGeneratedTopCellFragment.yaml
Lblproject'Coln'IsEventExpectedCellOpt	Lblproject'Coln'IsEventExpectedCellOpt.yaml
LblisCheatcodesCell	LblisCheatcodesCell.yaml
LblisScheduleConst	LblisScheduleConst.yaml
Lbl'Hash'HPEncode'LParUndsCommUndsRParUnds'SERIALIZATION'Unds'Bytes'Unds'Bytes'Unds'Int	Lbl'Hash'HPEncode'LParUndsCommUndsRParUnds'SERIALIZATION'Unds'Bytes'Unds'Bytes'Unds'Int.yaml
LblisAccounts	LblisAccounts.yaml
Lblproject'Coln'CodeCellOpt	Lblproject'Coln'CodeCellOpt.yaml
LblisScheduleFlag	LblisScheduleFlag.yaml
Lbl'Hash'asmTxPrefix'LParUndsRParUnds'EVM-TYPES'Unds'TxType'Unds'Int	Lbl'Hash'asmTxPrefix'LParUndsRParUnds'EVM-TYPES'Unds'TxType'Unds'Int.yaml
Lbl'Unds-LT-Eqls'Word'UndsUnds'EVM-TYPES'Unds'Int'Unds'Int'Unds'Int	Lbl'Unds-LT-Eqls'Word'UndsUnds'EVM-TYPES'Unds'Int'Unds'Int'Unds'Int.yaml
LblisTxTypeCellOpt	LblisTxTypeCellOpt.yaml
Lbl'Hash'ecrec'LParUndsCommUndsCommUndsCommUndsRParUnds'EVM'Unds'Bytes'Unds'Bytes'Unds'Bytes'Unds'Bytes'Unds'Bytes	Lbl'Hash'ecrec'LParUndsCommUndsCommUndsCommUndsRParUnds'EVM'Unds'Bytes'Unds'Bytes'Unds'Bytes'Unds'Bytes'Unds'Bytes.yaml
LblMap'Coln'lookup	LblMap'Coln'lookup.yaml
Lblmethod'Unds'lib'Perc'forge-std'Perc'src'Perc'VmSafe	Lblmethod'Unds'lib'Perc'forge-std'Perc'src'Perc'VmSafe.yaml
LblisS2KlibZModforgeZSubstdZModsrcZModStdInvariantMethod	LblisS2KlibZModforgeZSubstdZModsrcZModStdInvariantMethod.yaml
LblinitRefundCell	LblinitRefundCell.yaml
LblCextcodesize'LParUndsRParUnds'GAS-FEES'Unds'Int'Unds'Schedule	LblCextcodesize'LParUndsRParUnds'GAS-FEES'Unds'Int'Unds'Schedule.yaml
LblisPrevOriginCell	LblisPrevOriginCell.yaml
Lblproject'Coln'SigSCellOpt	Lblproject'Coln'SigSCellOpt.yaml
LblisStorageSlotSetCell	LblisStorageSlotSetCell.yaml
Lblproject'Coln'ExpectEmitCellOpt	Lblproject'Coln'ExpectEmitCellOpt.yaml
LblisEvmCell	LblisEvmCell.yaml
LblisInternalOp	LblisInternalOp.yaml
LblisBaseFeeCell	LblisBaseFeeCell.yaml
LblisStateRootCellOpt	LblisStateRootCellOpt.yaml
Lbl'Hash'memory'LParUndsCommUndsRParUnds'EVM'Unds'Int'Unds'OpCode'Unds'Int	Lbl'Hash'memory'LParUndsCommUndsRParUnds'EVM'Unds'Int'Unds'OpCode'Unds'Int.yaml
LblgetBloomFilterBit'LParUndsCommUndsRParUnds'EVM'Unds'Int'Unds'Bytes'Unds'Int	LblgetBloomFilterBit'LParUndsCommUndsRParUnds'EVM'Unds'Int'Unds'Bytes'Unds'Int.yaml
LblisMode	LblisMode.yaml
Lblproject'Coln'ExpectedDepthCellOpt	Lblproject'Coln'ExpectedDepthCellOpt.yaml
LblisGeneratedCounterCellOpt	LblisGeneratedCounterCellOpt.yaml
Lbl'UndsSlsh'Int'Unds'	Lbl'UndsSlsh'Int'Unds'.yaml
Lblproject'Coln'TernStackOp	Lblproject'Coln'TernStackOp.yaml
LblisBaseFeeCellOpt	LblisBaseFeeCellOpt.yaml
LblisContractAccess	LblisContractAccess.yaml
LblisKItem	LblisKItem.yaml
Lblproject'Coln'GasLimitCell	Lblproject'Coln'GasLimitCell.yaml
Lbl'Hash'rlpEncodeMerkleTree'LParUndsRParUnds'SERIALIZATION'Unds'Bytes'Unds'MerkleTree	Lbl'Hash'rlpEncodeMerkleTree'LParUndsRParUnds'SERIALIZATION'Unds'Bytes'Unds'MerkleTree.yaml
LblinitSigRCell	LblinitSigRCell.yaml
Lblproject'Coln'ScheduleFlag	Lblproject'Coln'ScheduleFlag.yaml
Lblproject'Coln'S2KlibZModforgeZSubstdZModsrcZModStdStyleContract	Lblproject'Coln'S2KlibZModforgeZSubstdZModsrcZModStdStyleContract.yaml
LblisIdCell	LblisIdCell.yaml
Lbl'Hash'wordBytes'LParUndsRParUnds'SERIALIZATION'Unds'Bytes'Unds'Int	Lbl'Hash'wordBytes'LParUndsRParUnds'SERIALIZATION'Unds'Bytes'Unds'Int.yaml
Lbl'Hash'multComplexity'LParUndsRParUnds'GAS-FEES'Unds'Int'Unds'Int	Lbl'Hash'multComplexity'LParUndsRParUnds'GAS-FEES'Unds'Int'Unds'Int.yaml
Lbl'UndsPlus'Word'UndsUnds'EVM-TYPES'Unds'Int'Unds'Int'Unds'Int	Lbl'UndsPlus'Word'UndsUnds'EVM-TYPES'Unds'Int'Unds'Int'Unds'Int.yaml
Lblproject'Coln'LocalMemCell	Lblproject'Coln'LocalMemCell.yaml
LblisNewOriginCellOpt	LblisNewOriginCellOpt.yaml
Lblproject'Coln'CodeCell	Lblproject'Coln'CodeCell.yaml
Lblproject'Coln'S2KlibZModforgeZSubstdZModsrcZModmocksZModIERC721TokenReceiverContract	Lblproject'Coln'S2KlibZModforgeZSubstdZModsrcZModmocksZModIERC721TokenReceiverContract.yaml
LblinitIdCell	LblinitIdCell.yaml
Lblproject'Coln'GeneratedCounterCellOpt	Lblproject'Coln'GeneratedCounterCellOpt.yaml
LblinitBlockhashesCell	LblinitBlockhashesCell.yaml
Lblproject'Coln'TxNonceCellOpt	Lblproject'Coln'TxNonceCellOpt.yaml
Lblproject'Coln'ModeCell	Lblproject'Coln'ModeCell.yaml
Lbl'UndsSlsh'Gas'UndsUnds'GAS-SYNTAX'Unds'Gas'Unds'Gas'Unds'Gas	Lbl'UndsSlsh'Gas'UndsUnds'GAS-SYNTAX'Unds'Gas'Unds'Gas'Unds'Gas.yaml
Lblproject'Coln'GeneratedCounterCell	Lblproject'Coln'GeneratedCounterCell.yaml
LblinitOpcodeTypeCell	LblinitOpcodeTypeCell.yaml
Lbl'Hash'inStorage'LParUndsCommUndsCommUndsRParUnds'EVM'Unds'Bool'Unds'Map'Unds'Account'Unds'Int	Lbl'Hash'inStorage'LParUndsCommUndsCommUndsRParUnds'EVM'Unds'Bool'Unds'Map'Unds'Account'Unds'Int.yaml
Lbl'Hash'bloomFilter'LParUndsRParUnds'EVM'Unds'Bytes'Unds'List	Lbl'Hash'bloomFilter'LParUndsRParUnds'EVM'Unds'Bytes'Unds'List.yaml
Lblproject'Coln'OpcodeTypeCellOpt	Lblproject'Coln'OpcodeTypeCellOpt.yaml
LblinitMsgIDCell	LblinitMsgIDCell.yaml
Lblproject'Coln'ActiveCellOpt	Lblproject'Coln'ActiveCellOpt.yaml
LblisMixHashCell	LblisMixHashCell.yaml
Lblproject'Coln'G1Point	Lblproject'Coln'G1Point.yaml
LblisBExp	LblisBExp.yaml
Lblproject'Coln'IsStorageWhitelistActiveCellOpt	Lblproject'Coln'IsStorageWhitelistActiveCellOpt.yaml
Lblproject'Coln'DifficultyCell	Lblproject'Coln'DifficultyCell.yaml
LblreverseJSONs'LParUndsRParUnds'JSON-EXT'Unds'JSONs'Unds'JSONs	LblreverseJSONs'LParUndsRParUnds'JSON-EXT'Unds'JSONs'Unds'JSONs.yaml
LblisScheduleCell	LblisScheduleCell.yaml
Lblproject'Coln'StringBuffer	Lblproject'Coln'StringBuffer.yaml
Lblproject'Coln'ExpectedReasonCellOpt	Lblproject'Coln'ExpectedReasonCellOpt.yaml
Lbl'Unds-LT-Eqls'Int'Unds'	Lbl'Unds-LT-Eqls'Int'Unds'.yaml
Lblproject'Coln'EthereumCellFragment	Lblproject'Coln'EthereumCellFragment.yaml
LblisToCell	LblisToCell.yaml
LblisMerkleTree	LblisMerkleTree.yaml
Lblproject'Coln'Map	Lblproject'Coln'Map.yaml
Lblproject'Coln'TxPriorityFeeCell	Lblproject'Coln'TxPriorityFeeCell.yaml
LblString2Bytes'LParUndsRParUnds'BYTES-HOOKED'Unds'Bytes'Unds'String	LblString2Bytes'LParUndsRParUnds'BYTES-HOOKED'Unds'Bytes'Unds'String.yaml
LblisExceptionalStatusCode	LblisExceptionalStatusCode.yaml
append	append.yaml
LblisS2KlibZModforgeZSubstdZModsrcZModstdErrorMethod	LblisS2KlibZModforgeZSubstdZModsrcZModstdErrorMethod.yaml
LblinitAccountsCell	LblinitAccountsCell.yaml
LblisFoundryContract	LblisFoundryContract.yaml
LblisEthereumCellFragment	LblisEthereumCellFragment.yaml
LblreverseJSONsAux'LParUndsCommUndsRParUnds'JSON-EXT'Unds'JSONs'Unds'JSONs'Unds'JSONs	LblreverseJSONsAux'LParUndsCommUndsRParUnds'JSON-EXT'Unds'JSONs'Unds'JSONs'Unds'JSONs.yaml
Lbl'Hash'padRightToWidth'LParUndsCommUndsRParUnds'EVM-TYPES'Unds'Bytes'Unds'Int'Unds'Bytes	Lbl'Hash'padRightToWidth'LParUndsCommUndsRParUnds'EVM-TYPES'Unds'Bytes'Unds'Int'Unds'Bytes.yaml
LblisAccountsCellOpt	LblisAccountsCellOpt.yaml
Lbl'UndsXor-'Word'UndsUnds'EVM-TYPES'Unds'Int'Unds'Int'Unds'Int	Lbl'UndsXor-'Word'UndsUnds'EVM-TYPES'Unds'Int'Unds'Int'Unds'Int.yaml
LblisS2KlibZModforgeZSubstdZModsrcZModScriptBaseContract	LblisS2KlibZModforgeZSubstdZModsrcZModScriptBaseContract.yaml
LblisOmmersHashCellOpt	LblisOmmersHashCellOpt.yaml
Lbl'Hash'sender'LParUndsRParUnds'SERIALIZATION'Unds'Account'Unds'Bytes	Lbl'Hash'sender'LParUndsRParUnds'SERIALIZATION'Unds'Account'Unds'Bytes.yaml
LblisLocalMemCell	LblisLocalMemCell.yaml
LblSetItem	LblSetItem.yaml
LblfreshInt'LParUndsRParUnds'INT'Unds'Int'Unds'Int	LblfreshInt'LParUndsRParUnds'INT'Unds'Int'Unds'Int.yaml
Lblproject'Coln'GasUsedCell	Lblproject'Coln'GasUsedCell.yaml
LblisS2KlibZModforgeZSubstdZModsrcZModmocksZModIERC721TokenReceiverMethod	LblisS2KlibZModforgeZSubstdZModsrcZModmocksZModIERC721TokenReceiverMethod.yaml
Lbl'Hash'checkTopic'LParUndsCommUndsCommUndsRParUnds'FOUNDRY-CHEAT-CODES'Unds'Bool'Unds'Bool'Unds'Int'Unds'Int	Lbl'Hash'checkTopic'LParUndsCommUndsCommUndsRParUnds'FOUNDRY-CHEAT-CODES'Unds'Bool'Unds'Bool'Unds'Int'Unds'Int.yaml
LblString2Bool'LParUndsRParUnds'STRING-COMMON'Unds'Bool'Unds'String	LblString2Bool'LParUndsRParUnds'STRING-COMMON'Unds'Bool'Unds'String.yaml
Lblproject'Coln'BlockNonceCell	Lblproject'Coln'BlockNonceCell.yaml
Lblproject'Coln'ChainIDCell	Lblproject'Coln'ChainIDCell.yaml
LblStatusCode2String'LParUndsRParUnds'NETWORK'Unds'String'Unds'StatusCode	LblStatusCode2String'LParUndsRParUnds'NETWORK'Unds'String'Unds'StatusCode.yaml
LblisSigRCell	LblisSigRCell.yaml
Lblproject'Coln'NonceCell	Lblproject'Coln'NonceCell.yaml
LblinitTxNonceCell	LblinitTxNonceCell.yaml
Lblproject'Coln'RefundCell	Lblproject'Coln'RefundCell.yaml
LblisExpectEmitCell	LblisExpectEmitCell.yaml
LblisStorageCell	LblisStorageCell.yaml
Lbl'Unds'orElseBool'Unds'	Lbl'Unds'orElseBool'Unds'.yaml
Lbl'Unds-GT--GT-'Word'UndsUnds'EVM-TYPES'Unds'Int'Unds'Int'Unds'Int	Lbl'Unds-GT--GT-'Word'UndsUnds'EVM-TYPES'Unds'Int'Unds'Int'Unds'Int.yaml
LblMerklePut'LParUndsCommUndsCommUndsRParUnds'SERIALIZATION'Unds'MerkleTree'Unds'MerkleTree'Unds'Bytes'Unds'String	LblMerklePut'LParUndsCommUndsCommUndsRParUnds'SERIALIZATION'Unds'MerkleTree'Unds'MerkleTree'Unds'Bytes'Unds'String.yaml
LblinitTxOrderCell	LblinitTxOrderCell.yaml
Lblproject'Coln'AccessListTxData'LParUndsCommUndsCommUndsCommUndsCommUndsCommUndsCommUndsCommUndsRParUnds'EVM-TYPES'Unds'AccessListTx'Unds'Int'Unds'Int'Unds'Int'Unds'Account'Unds'Int'Unds'Bytes'Unds'Int'Unds'JSONs'Coln'chainId	Lblproject'Coln'AccessListTxData'LParUndsCommUndsCommUndsCommUndsCommUndsCommUndsCommUndsCommUndsRParUnds'EVM-TYPES'Unds'AccessListTx'Unds'Int'Unds'Int'Unds'Int'Unds'Account'Unds'Int'Unds'Bytes'Unds'Int'Unds'JSONs'Coln'chainId.yaml
Lbl'UndsLSqBUndsRSqB'orDefault'UndsUnds'MAP'Unds'KItem'Unds'Map'Unds'KItem'Unds'KItem	Lbl'UndsLSqBUndsRSqB'orDefault'UndsUnds'MAP'Unds'KItem'Unds'Map'Unds'KItem'Unds'KItem.yaml
LblinitSigSCell	LblinitSigSCell.yaml
Lblcontract'Unds'access'Unds'loc	Lblcontract'Unds'access'Unds'loc.yaml
Lblproject'Coln'FoundryContract	Lblproject'Coln'FoundryContract.yaml
LblECDSARecoverbytes'LParUndsCommUndsCommUndsCommUndsRParUnds'SERIALIZATION'Unds'Bytes'Unds'Bytes'Unds'Int'Unds'Bytes'Unds'Bytes	LblECDSARecoverbytes'LParUndsCommUndsCommUndsCommUndsRParUnds'SERIALIZATION'Unds'Bytes'Unds'Bytes'Unds'Int'Unds'Bytes'Unds'Bytes.yaml
LblisKevmCellOpt	LblisKevmCellOpt.yaml
Lbl'Tild'Int'Unds'	Lbl'Tild'Int'Unds'.yaml
LblisExtraDataCellOpt	LblisExtraDataCellOpt.yaml
Lblproject'Coln'S2KlibZModforgeZSubstdZModsrcZModstdErrorContract	Lblproject'Coln'S2KlibZModforgeZSubstdZModsrcZModstdErrorContract.yaml
LblreplaceFirst'LParUndsCommUndsCommUndsRParUnds'STRING-COMMON'Unds'String'Unds'String'Unds'String'Unds'String	LblreplaceFirst'LParUndsCommUndsCommUndsRParUnds'STRING-COMMON'Unds'String'Unds'String'Unds'String'Unds'String.yaml
LblsubstrBytes'LParUndsCommUndsCommUndsRParUnds'BYTES-HOOKED'Unds'Bytes'Unds'Bytes'Unds'Int'Unds'Int	LblsubstrBytes'LParUndsCommUndsCommUndsRParUnds'BYTES-HOOKED'Unds'Bytes'Unds'Bytes'Unds'Int'Unds'Int.yaml
LblinitCheckedDataCell	LblinitCheckedDataCell.yaml
Lblproject'Coln'MsgIDCell	Lblproject'Coln'MsgIDCell.yaml
Lblproject'Coln'LengthPrefix	Lblproject'Coln'LengthPrefix.yaml
Lbl'UndsStar'Gas'UndsUnds'GAS-SYNTAX'Unds'Gas'Unds'Gas'Unds'Gas	Lbl'UndsStar'Gas'UndsUnds'GAS-SYNTAX'Unds'Gas'Unds'Gas'Unds'Gas.yaml
LblG0'LParUndsCommUndsCommUndsRParUnds'GAS-FEES'Unds'Int'Unds'Schedule'Unds'Bytes'Unds'Bool	LblG0'LParUndsCommUndsCommUndsRParUnds'GAS-FEES'Unds'Int'Unds'Schedule'Unds'Bytes'Unds'Bool.yaml
Lblproject'Coln'FoundryField	Lblproject'Coln'FoundryField.yaml
Lblproject'Coln'LegacyTxData'LParUndsCommUndsCommUndsCommUndsCommUndsCommUndsRParUnds'EVM-TYPES'Unds'LegacyTx'Unds'Int'Unds'Int'Unds'Int'Unds'Account'Unds'Int'Unds'Bytes'Coln'value	Lblproject'Coln'LegacyTxData'LParUndsCommUndsCommUndsCommUndsCommUndsCommUndsRParUnds'EVM-TYPES'Unds'LegacyTx'Unds'Int'Unds'Int'Unds'Int'Unds'Account'Unds'Int'Unds'Bytes'Coln'value.yaml
Lblvalues'LParUndsRParUnds'MAP'Unds'List'Unds'Map	Lblvalues'LParUndsRParUnds'MAP'Unds'List'Unds'Map.yaml
LblisCallGasCell	LblisCallGasCell.yaml
LblisExpectEmitCellFragment	LblisExpectEmitCellFragment.yaml
LblinitDifficultyCell	LblinitDifficultyCell.yaml
LblisMessageCell	LblisMessageCell.yaml
Lbl'Hash'merkleExtensionBrancher'LParUndsCommUndsCommUndsRParUnds'SERIALIZATION'Unds'MerkleTree'Unds'MerkleTree'Unds'Bytes'Unds'MerkleTree	Lbl'Hash'merkleExtensionBrancher'LParUndsCommUndsCommUndsRParUnds'SERIALIZATION'Unds'MerkleTree'Unds'MerkleTree'Unds'Bytes'Unds'MerkleTree.yaml
Lbl'Hash'stackNeeded'LParUndsRParUnds'EVM'Unds'Int'Unds'OpCode	Lbl'Hash'stackNeeded'LParUndsRParUnds'EVM'Unds'Int'Unds'OpCode.yaml
LblisTxTypeCell	LblisTxTypeCell.yaml
Lblproject'Coln'CallDepthCellOpt	Lblproject'Coln'CallDepthCellOpt.yaml
LblECDSASign'LParUndsCommUndsRParUnds'KRYPTO'Unds'String'Unds'String'Unds'String	LblECDSASign'LParUndsCommUndsRParUnds'KRYPTO'Unds'String'Unds'String'Unds'String.yaml
Lbl'Unds-GT-'String'UndsUnds'STRING-COMMON'Unds'Bool'Unds'String'Unds'String	Lbl'Unds-GT-'String'UndsUnds'STRING-COMMON'Unds'Bool'Unds'String'Unds'String.yaml
Lblproject'Coln'TxChainIDCellOpt	Lblproject'Coln'TxChainIDCellOpt.yaml
LblisEthereumCell	LblisEthereumCell.yaml
Lbl'Hash'isStaticType'LParUndsRParUnds'EVM-ABI'Unds'Bool'Unds'TypedArg	Lbl'Hash'isStaticType'LParUndsRParUnds'EVM-ABI'Unds'Bool'Unds'TypedArg.yaml
LblisAccessListTx	LblisAccessListTx.yaml
Lbl'Hash'getEventTopics'LParUndsCommUndsRParUnds'EVM-ABI'Unds'List'Unds'String'Unds'EventArgs	Lbl'Hash'getEventTopics'LParUndsCommUndsRParUnds'EVM-ABI'Unds'List'Unds'String'Unds'EventArgs.yaml
Lblproject'Coln'CoinbaseCell	Lblproject'Coln'CoinbaseCell.yaml
Lbl'Unds-GT--GT-'sWord'UndsUnds'EVM-TYPES'Unds'Int'Unds'Int'Unds'Int	Lbl'Unds-GT--GT-'sWord'UndsUnds'EVM-TYPES'Unds'Int'Unds'Int'Unds'Int.yaml
Lblproject'Coln'RecordEventCellOpt	Lblproject'Coln'RecordEventCellOpt.yaml
Lbl'Unds-GT--GT-'Int'Unds'	Lbl'Unds-GT--GT-'Int'Unds'.yaml
LblinitSingleCallCell	LblinitSingleCallCell.yaml
LblinitStaticCell	LblinitStaticCell.yaml
Lblproject'Coln'DynamicFeeTxData'LParUndsCommUndsCommUndsCommUndsCommUndsCommUndsCommUndsCommUndsCommUndsRParUnds'EVM-TYPES'Unds'DynamicFeeTx'Unds'Int'Unds'Int'Unds'Int'Unds'Int'Unds'Account'Unds'Int'Unds'Bytes'Unds'Int'Unds'JSONs'Coln'data	Lblproject'Coln'DynamicFeeTxData'LParUndsCommUndsCommUndsCommUndsCommUndsCommUndsCommUndsCommUndsCommUndsRParUnds'EVM-TYPES'Unds'DynamicFeeTx'Unds'Int'Unds'Int'Unds'Int'Unds'Int'Unds'Account'Unds'Int'Unds'Bytes'Unds'Int'Unds'JSONs'Coln'data.yaml
LblisAddr2Op'LParUndsRParUnds'EVM'Unds'Bool'Unds'OpCode	LblisAddr2Op'LParUndsRParUnds'EVM'Unds'Bool'Unds'OpCode.yaml
LblisPrevOriginCellOpt	LblisPrevOriginCellOpt.yaml
Lbl'Hash'rlpMerkleH'LParUndsRParUnds'SERIALIZATION'Unds'Bytes'Unds'Bytes	Lbl'Hash'rlpMerkleH'LParUndsRParUnds'SERIALIZATION'Unds'Bytes'Unds'Bytes.yaml
Lblproject'Coln'BlockCell	Lblproject'Coln'BlockCell.yaml
Lbl'Unds-LT-'String'UndsUnds'STRING-COMMON'Unds'Bool'Unds'String'Unds'String	Lbl'Unds-LT-'String'UndsUnds'STRING-COMMON'Unds'Bool'Unds'String'Unds'String.yaml
Lblproject'Coln'WordStackCell	Lblproject'Coln'WordStackCell.yaml
LblisExpectedOpcodeCellFragment	LblisExpectedOpcodeCellFragment.yaml
LblisLogsBloomCell	LblisLogsBloomCell.yaml
LblInt2Bytes'LParUndsCommUndsCommUndsRParUnds'BYTES-HOOKED'Unds'Bytes'Unds'Int'Unds'Endianness'Unds'Signedness	LblInt2Bytes'LParUndsCommUndsCommUndsRParUnds'BYTES-HOOKED'Unds'Bytes'Unds'Int'Unds'Endianness'Unds'Signedness.yaml
Lblproject'Coln'AccessedAccountsCell	Lblproject'Coln'AccessedAccountsCell.yaml
Lblmethod'Unds'lib'Perc'kontrol-cheatcodes'Perc'src'Perc'KontrolCheats	Lblmethod'Unds'lib'Perc'kontrol-cheatcodes'Perc'src'Perc'KontrolCheats.yaml
LblCsstore'LParUndsCommUndsCommUndsCommUndsRParUnds'GAS-FEES'Unds'Int'Unds'Schedule'Unds'Int'Unds'Int'Unds'Int	LblCsstore'LParUndsCommUndsCommUndsCommUndsRParUnds'GAS-FEES'Unds'Int'Unds'Schedule'Unds'Int'Unds'Int'Unds'Int.yaml
LblisJSONs	LblisJSONs.yaml
Lbl'Hash'take'LParUndsCommUndsRParUnds'EVM-TYPES'Unds'WordStack'Unds'Int'Unds'WordStack	Lbl'Hash'take'LParUndsCommUndsRParUnds'EVM-TYPES'Unds'WordStack'Unds'Int'Unds'WordStack.yaml
LblisTxAccessCell	LblisTxAccessCell.yaml
Lbl'Hash'precompiled'LParUndsRParUnds'EVM'Unds'PrecompiledOp'Unds'Int	Lbl'Hash'precompiled'LParUndsRParUnds'EVM'Unds'PrecompiledOp'Unds'Int.yaml
Lblproject'Coln'S2KlibZModforgeZSubstdZModsrcZModScriptContract	Lblproject'Coln'S2KlibZModforgeZSubstdZModsrcZModScriptContract.yaml
Lbl'UndsPipe'-'-GT-Unds'	Lbl'UndsPipe'-'-GT-Unds'.yaml
LblinitToCell	LblinitToCell.yaml
Lblproject'Coln'S2KlibZModforgeZSubstdZModsrcZModinterfacesZModIMulticall3Method	Lblproject'Coln'S2KlibZModforgeZSubstdZModsrcZModinterfacesZModIMulticall3Method.yaml
Lbl'Hash'dasmOpCode'LParUndsCommUndsRParUnds'EVM'Unds'OpCode'Unds'Int'Unds'Schedule	Lbl'Hash'dasmOpCode'LParUndsCommUndsRParUnds'EVM'Unds'OpCode'Unds'Int'Unds'Schedule.yaml
Lblproject'Coln'EventArgs	Lblproject'Coln'EventArgs.yaml
LblisNetworkCellOpt	LblisNetworkCellOpt.yaml
LblreplaceAtBytes'LParUndsCommUndsCommUndsRParUnds'BYTES-HOOKED'Unds'Bytes'Unds'Bytes'Unds'Int'Unds'Bytes	LblreplaceAtBytes'LParUndsCommUndsCommUndsRParUnds'BYTES-HOOKED'Unds'Bytes'Unds'Bytes'Unds'Int'Unds'Bytes.yaml
Lblproject'Coln'Float	Lblproject'Coln'Float.yaml
LblinitOutputCell	LblinitOutputCell.yaml
LblupdateMap'LParUndsCommUndsRParUnds'MAP'Unds'Map'Unds'Map'Unds'Map	LblupdateMap'LParUndsCommUndsRParUnds'MAP'Unds'Map'Unds'Map'Unds'Map.yaml
Lblproject'Coln'ExpectedRevertCellFragment	Lblproject'Coln'ExpectedRevertCellFragment.yaml
LblisTxMaxFeeCell	LblisTxMaxFeeCell.yaml
Lblproject'Coln'ExitCodeCellOpt	Lblproject'Coln'ExitCodeCellOpt.yaml
LblinitOrigStorageCell	LblinitOrigStorageCell.yaml
LblisBlockhashesCellOpt	LblisBlockhashesCellOpt.yaml
Lblproject'Coln'MixHashCellOpt	Lblproject'Coln'MixHashCellOpt.yaml
LblinitExpectedValueCell	LblinitExpectedValueCell.yaml
Lbl'Hash'abiEventLog'LParUndsCommUndsCommUndsRParUnds'EVM-ABI'Unds'SubstateLogEntry'Unds'Int'Unds'String'Unds'EventArgs	Lbl'Hash'abiEventLog'LParUndsCommUndsCommUndsRParUnds'EVM-ABI'Unds'SubstateLogEntry'Unds'Int'Unds'String'Unds'EventArgs.yaml
LblisChainIDCellOpt	LblisChainIDCellOpt.yaml
Lbl'UndsPerc'Int'Unds'	Lbl'UndsPerc'Int'Unds'.yaml
Lblmethod'Unds'lib'Perc'forge-std'Perc'src'Perc'interfaces'Perc'IMulticall3	Lblmethod'Unds'lib'Perc'forge-std'Perc'src'Perc'interfaces'Perc'IMulticall3.yaml
Lblproject'Coln'CallStateCell	Lblproject'Coln'CallStateCell.yaml
Lbl'Unds-LT--LT-'Int'Unds'	Lbl'Unds-LT--LT-'Int'Unds'.yaml
Lblproject'Coln'NewOriginCell	Lblproject'Coln'NewOriginCell.yaml
Lblproject'Coln'LegacyProtectedTxData'LParUndsCommUndsCommUndsCommUndsCommUndsCommUndsCommUndsRParUnds'EVM-TYPES'Unds'LegacyTx'Unds'Int'Unds'Int'Unds'Int'Unds'Account'Unds'Int'Unds'Bytes'Unds'Int'Coln'data	Lblproject'Coln'LegacyProtectedTxData'LParUndsCommUndsCommUndsCommUndsCommUndsCommUndsCommUndsRParUnds'EVM-TYPES'Unds'LegacyTx'Unds'Int'Unds'Int'Unds'Int'Unds'Account'Unds'Int'Unds'Bytes'Unds'Int'Coln'data.yaml
Lbl'Hash'typeName'LParUndsRParUnds'EVM-ABI'Unds'String'Unds'TypedArg	Lbl'Hash'typeName'LParUndsRParUnds'EVM-ABI'Unds'String'Unds'TypedArg.yaml
Lblproject'Coln'AccessListTxData'LParUndsCommUndsCommUndsCommUndsCommUndsCommUndsCommUndsCommUndsRParUnds'EVM-TYPES'Unds'AccessListTx'Unds'Int'Unds'Int'Unds'Int'Unds'Account'Unds'Int'Unds'Bytes'Unds'Int'Unds'JSONs'Coln'accessLists	Lblproject'Coln'AccessListTxData'LParUndsCommUndsCommUndsCommUndsCommUndsCommUndsCommUndsCommUndsRParUnds'EVM-TYPES'Unds'AccessListTx'Unds'Int'Unds'Int'Unds'Int'Unds'Account'Unds'Int'Unds'Bytes'Unds'Int'Unds'JSONs'Coln'accessLists.yaml
LblinitCoinbaseCell	LblinitCoinbaseCell.yaml
Lblproject'Coln'ExpectedDepthCell	Lblproject'Coln'ExpectedDepthCell.yaml
LblinitValueCell	LblinitValueCell.yaml
Lblproject'Coln'S2KlibZModforgeZSubstdZModsrcZModmocksZModMockERC721Contract	Lblproject'Coln'S2KlibZModforgeZSubstdZModsrcZModmocksZModMockERC721Contract.yaml
Lbl'Hash'newAddr'LParUndsCommUndsCommUndsRParUnds'SERIALIZATION'Unds'Int'Unds'Int'Unds'Int'Unds'Bytes	Lbl'Hash'newAddr'LParUndsCommUndsCommUndsRParUnds'SERIALIZATION'Unds'Int'Unds'Int'Unds'Int'Unds'Bytes.yaml
LblinitChainIDCell	LblinitChainIDCell.yaml
Lblproject'Coln'SelfDestructCell	Lblproject'Coln'SelfDestructCell.yaml
Lblproject'Coln'List	Lblproject'Coln'List.yaml
LblisS2KlibZModforgeZSubstdZModsrcZModStdCheatsSafeContract	LblisS2KlibZModforgeZSubstdZModsrcZModStdCheatsSafeContract.yaml
Lblproject'Coln'CallStateCellOpt	Lblproject'Coln'CallStateCellOpt.yaml
Lblproject'Coln'BlockNonceCellOpt	Lblproject'Coln'BlockNonceCellOpt.yaml
LblinitAcctIDCell	LblinitAcctIDCell.yaml
LblisExpectedValueCellOpt	LblisExpectedValueCellOpt.yaml
Lbl'Hash'unparseDataBytes'LParUndsRParUnds'SERIALIZATION'Unds'String'Unds'Bytes	Lbl'Hash'unparseDataBytes'LParUndsRParUnds'SERIALIZATION'Unds'String'Unds'Bytes.yaml
Lblproject'Coln'S2KlibZModforgeZSubstdZModsrcZModScriptMethod	Lblproject'Coln'S2KlibZModforgeZSubstdZModsrcZModScriptMethod.yaml
LblisS2KlibZModforgeZSubstdZModsrcZModsafeconsoleContract	LblisS2KlibZModforgeZSubstdZModsrcZModsafeconsoleContract.yaml
Lbl'Hash'parseHexBytesAux'LParUndsRParUnds'SERIALIZATION'Unds'Bytes'Unds'String	Lbl'Hash'parseHexBytesAux'LParUndsRParUnds'SERIALIZATION'Unds'Bytes'Unds'String.yaml
Lblproject'Coln'StateRootCellOpt	Lblproject'Coln'StateRootCellOpt.yaml
LblisTimestampCell	LblisTimestampCell.yaml
LblisS2KlibZModforgeZSubstdZModsrcZModstdStorageContract	LblisS2KlibZModforgeZSubstdZModsrcZModstdStorageContract.yaml
LblinitIsRevertExpectedCell	LblinitIsRevertExpectedCell.yaml
Lblproject'Coln'LegacyProtectedTxData'LParUndsCommUndsCommUndsCommUndsCommUndsCommUndsCommUndsRParUnds'EVM-TYPES'Unds'LegacyTx'Unds'Int'Unds'Int'Unds'Int'Unds'Account'Unds'Int'Unds'Bytes'Unds'Int'Coln'chainId	Lblproject'Coln'LegacyProtectedTxData'LParUndsCommUndsCommUndsCommUndsCommUndsCommUndsCommUndsRParUnds'EVM-TYPES'Unds'LegacyTx'Unds'Int'Unds'Int'Unds'Int'Unds'Account'Unds'Int'Unds'Bytes'Unds'Int'Coln'chainId.yaml
LblinitFoundryCell	LblinitFoundryCell.yaml
LblCsload'LParUndsCommUndsRParUnds'GAS-FEES'Unds'Int'Unds'Schedule'Unds'Bool	LblCsload'LParUndsCommUndsRParUnds'GAS-FEES'Unds'Int'Unds'Schedule'Unds'Bool.yaml
Lbl'Hash'sizeOfDynamicTypeAux'LParUndsRParUnds'EVM-ABI'Unds'Int'Unds'TypedArgs	Lbl'Hash'sizeOfDynamicTypeAux'LParUndsRParUnds'EVM-ABI'Unds'Int'Unds'TypedArgs.yaml
LblsignExtendBitRangeInt'LParUndsCommUndsCommUndsRParUnds'INT-COMMON'Unds'Int'Unds'Int'Unds'Int'Unds'Int	LblsignExtendBitRangeInt'LParUndsCommUndsCommUndsRParUnds'INT-COMMON'Unds'Int'Unds'Int'Unds'Int'Unds'Int.yaml
Lbl'UndsEqlsSlshEqls'Bool'Unds'	Lbl'UndsEqlsSlshEqls'Bool'Unds'.yaml
Lblproject'Coln'CallStateCellFragment	Lblproject'Coln'CallStateCellFragment.yaml
Lblproject'Coln'TypedArgs	Lblproject'Coln'TypedArgs.yaml
LblisStorageSlotSetCellOpt	LblisStorageSlotSetCellOpt.yaml
Lbl'Hash'widthOp'LParUndsRParUnds'EVM'Unds'Int'Unds'OpCode	Lbl'Hash'widthOp'LParUndsRParUnds'EVM'Unds'Int'Unds'OpCode.yaml
LblisNonceCell	LblisNonceCell.yaml
Lbl'Hash'abiCallData'LParUndsCommUndsRParUnds'EVM-ABI'Unds'Bytes'Unds'String'Unds'TypedArgs	Lbl'Hash'abiCallData'LParUndsCommUndsRParUnds'EVM-ABI'Unds'Bytes'Unds'String'Unds'TypedArgs.yaml
Lblproject'Coln'KResult	Lblproject'Coln'KResult.yaml
Lblpowmod'LParUndsCommUndsCommUndsRParUnds'EVM-TYPES'Unds'Int'Unds'Int'Unds'Int'Unds'Int	Lblpowmod'LParUndsCommUndsCommUndsRParUnds'EVM-TYPES'Unds'Int'Unds'Int'Unds'Int'Unds'Int.yaml
Lblproject'Coln'S2KsrcZModCounterContract	Lblproject'Coln'S2KsrcZModCounterContract.yaml
LblinitGasLimitCell	LblinitGasLimitCell.yaml
Lbl'UndsLSqBUndsRSqBUnds'BYTES-HOOKED'Unds'Int'Unds'Bytes'Unds'Int	Lbl'UndsLSqBUndsRSqBUnds'BYTES-HOOKED'Unds'Int'Unds'Bytes'Unds'Int.yaml
Lbl'Hash'rlpEncode'LParUndsCommUndsRParUnds'SERIALIZATION'Unds'Bytes'Unds'JSONs'Unds'StringBuffer	Lbl'Hash'rlpEncode'LParUndsCommUndsRParUnds'SERIALIZATION'Unds'Bytes'Unds'JSONs'Unds'StringBuffer.yaml
LblisS2KlibZModforgeZSubstdZModsrcZModStdAssertionsMethod	LblisS2KlibZModforgeZSubstdZModsrcZModStdAssertionsMethod.yaml
LblisOpcodeType	LblisOpcodeType.yaml
Lblproject'Coln'OrigStorageCellOpt	Lblproject'Coln'OrigStorageCellOpt.yaml
Lbl'Hash'encodeOutput'LParUndsRParUnds'FOUNDRY-CHEAT-CODES'Unds'Bytes'Unds'Bytes	Lbl'Hash'encodeOutput'LParUndsRParUnds'FOUNDRY-CHEAT-CODES'Unds'Bytes'Unds'Bytes.yaml
LblInt2Bytes'LParUndsCommUndsCommUndsRParUnds'BYTES-HOOKED'Unds'Bytes'Unds'Int'Unds'Int'Unds'Endianness	LblInt2Bytes'LParUndsCommUndsCommUndsRParUnds'BYTES-HOOKED'Unds'Bytes'Unds'Int'Unds'Int'Unds'Endianness.yaml
Lblproject'Coln'NumberCell	Lblproject'Coln'NumberCell.yaml
LblisBytes	LblisBytes.yaml
LblisEvmCellOpt	LblisEvmCellOpt.yaml
LblisIsStorageWhitelistActiveCell	LblisIsStorageWhitelistActiveCell.yaml
LblisAcctIDCell	LblisAcctIDCell.yaml
Lblproject'Coln'OmmersHashCellOpt	Lblproject'Coln'OmmersHashCellOpt.yaml
LblinitBlockCell	LblinitBlockCell.yaml
LblCmodexp'LParUndsCommUndsCommUndsCommUndsCommUndsRParUnds'GAS-FEES'Unds'Int'Unds'Schedule'Unds'Bytes'Unds'Int'Unds'Int'Unds'Int	LblCmodexp'LParUndsCommUndsCommUndsCommUndsCommUndsRParUnds'GAS-FEES'Unds'Int'Unds'Schedule'Unds'Bytes'Unds'Int'Unds'Int'Unds'Int.yaml
Lbl'Hash'generateSignatureArgs'LParUndsRParUnds'EVM-ABI'Unds'String'Unds'TypedArgs	Lbl'Hash'generateSignatureArgs'LParUndsRParUnds'EVM-ABI'Unds'String'Unds'TypedArgs.yaml
LblisTransactionsRootCell	LblisTransactionsRootCell.yaml
Lblproject'Coln'DynamicFeeTx	Lblproject'Coln'DynamicFeeTx.yaml
LblisReceiptsRootCellOpt	LblisReceiptsRootCellOpt.yaml
LblisProgramCellOpt	LblisProgramCellOpt.yaml
Lbl'Unds-LT--LT-'Byte'UndsUnds'WORD'Unds'Int'Unds'Int'Unds'Int	Lbl'Unds-LT--LT-'Byte'UndsUnds'WORD'Unds'Int'Unds'Int'Unds'Int.yaml
LblCbalance'LParUndsRParUnds'GAS-FEES'Unds'Int'Unds'Schedule	LblCbalance'LParUndsRParUnds'GAS-FEES'Unds'Int'Unds'Schedule.yaml
Lbl'Hash'decodeLengthPrefix'LParUndsCommUndsRParUnds'SERIALIZATION'Unds'LengthPrefix'Unds'Bytes'Unds'Int	Lbl'Hash'decodeLengthPrefix'LParUndsCommUndsRParUnds'SERIALIZATION'Unds'LengthPrefix'Unds'Bytes'Unds'Int.yaml
LblisSubstateCellFragment	LblisSubstateCellFragment.yaml
LblisSingleCallCell	LblisSingleCallCell.yaml
LblisAccountsCell	LblisAccountsCell.yaml
LblinitStorageCell	LblinitStorageCell.yaml
Lblproject'Coln'OmmersHashCell	Lblproject'Coln'OmmersHashCell.yaml
Lblproject'Coln'AccessedAccountsCellOpt	Lblproject'Coln'AccessedAccountsCellOpt.yaml
Lblproject'Coln'AccountCode	Lblproject'Coln'AccountCode.yaml
Lblproject'Coln'LegacyProtectedTxData'LParUndsCommUndsCommUndsCommUndsCommUndsCommUndsCommUndsRParUnds'EVM-TYPES'Unds'LegacyTx'Unds'Int'Unds'Int'Unds'Int'Unds'Account'Unds'Int'Unds'Bytes'Unds'Int'Coln'to	Lblproject'Coln'LegacyProtectedTxData'LParUndsCommUndsCommUndsCommUndsCommUndsCommUndsCommUndsRParUnds'EVM-TYPES'Unds'LegacyTx'Unds'Int'Unds'Int'Unds'Int'Unds'Account'Unds'Int'Unds'Bytes'Unds'Int'Coln'to.yaml
LblinitGasPriceCell	LblinitGasPriceCell.yaml
Lblproject'Coln'TxTypeCellOpt	Lblproject'Coln'TxTypeCellOpt.yaml
Lblproject'Coln'TouchedAccountsCellOpt	Lblproject'Coln'TouchedAccountsCellOpt.yaml
LblisStackOp	LblisStackOp.yaml
LblisSigVCellOpt	LblisSigVCellOpt.yaml
Lblproject'Coln'Accounts	Lblproject'Coln'Accounts.yaml
LblisUseGasCell	LblisUseGasCell.yaml
Lbl'Hash'nibbleize'LParUndsRParUnds'SERIALIZATION'Unds'Bytes'Unds'Bytes	Lbl'Hash'nibbleize'LParUndsRParUnds'SERIALIZATION'Unds'Bytes'Unds'Bytes.yaml
Lblproject'Coln'BExp	Lblproject'Coln'BExp.yaml
LblinitPrankCell	LblinitPrankCell.yaml
Lblproject'Coln'StorageSlot	Lblproject'Coln'StorageSlot.yaml
Lblproject'Coln'SubstateCell	Lblproject'Coln'SubstateCell.yaml
Lbl'Unds'AccountCellMap'Unds'	Lbl'Unds'AccountCellMap'Unds'.yaml
LblBN128Mul'LParUndsCommUndsRParUnds'KRYPTO'Unds'G1Point'Unds'G1Point'Unds'Int	LblBN128Mul'LParUndsCommUndsRParUnds'KRYPTO'Unds'G1Point'Unds'G1Point'Unds'Int.yaml
LblisS2KlibZModforgeZSubstdZModsrcZModScriptContract	LblisS2KlibZModforgeZSubstdZModsrcZModScriptContract.yaml
LblinitTxPriorityFeeCell	LblinitTxPriorityFeeCell.yaml
LblisMemoryUsedCellOpt	LblisMemoryUsedCellOpt.yaml
Lbl'Hash'computeValidJumpDests'LParUndsCommUndsCommUndsRParUnds'EVM'Unds'Set'Unds'Bytes'Unds'Int'Unds'List	Lbl'Hash'computeValidJumpDests'LParUndsCommUndsCommUndsRParUnds'EVM'Unds'Set'Unds'Bytes'Unds'Int'Unds'List.yaml
Lblproject'Coln'TxGasLimitCellOpt	Lblproject'Coln'TxGasLimitCellOpt.yaml
LblisScheduleCellOpt	LblisScheduleCellOpt.yaml
Lblmethod'Unds'lib'Perc'forge-std'Perc'src'Perc'mocks'Perc'IERC721TokenReceiver	Lblmethod'Unds'lib'Perc'forge-std'Perc'src'Perc'mocks'Perc'IERC721TokenReceiver.yaml
LblinitWordStackCell	LblinitWordStackCell.yaml
LblinitBaseFeeCell	LblinitBaseFeeCell.yaml
LblinitWhitelistCell	LblinitWhitelistCell.yaml
Lbl'Hash'inStorageAux2'LParUndsCommUndsRParUnds'EVM'Unds'Bool'Unds'Set'Unds'Int	Lbl'Hash'inStorageAux2'LParUndsCommUndsRParUnds'EVM'Unds'Bool'Unds'Set'Unds'Int.yaml
LblisExpectedDataCell	LblisExpectedDataCell.yaml
Lblproject'Coln'S2KlibZModforgeZSubstdZModsrcZModVmSafeMethod	Lblproject'Coln'S2KlibZModforgeZSubstdZModsrcZModVmSafeMethod.yaml
LblisTxGasPriceCellOpt	LblisTxGasPriceCellOpt.yaml
LblisCallStackCell	LblisCallStackCell.yaml
LblinitTxGasLimitCell	LblinitTxGasLimitCell.yaml
Lblproject'Coln'SingleCallCellOpt	Lblproject'Coln'SingleCallCellOpt.yaml
LblisJSONKey	LblisJSONKey.yaml
Lbl'Hash'getNonIndexedArgs'LParUndsRParUnds'EVM-ABI'Unds'TypedArgs'Unds'EventArgs	Lbl'Hash'getNonIndexedArgs'LParUndsRParUnds'EVM-ABI'Unds'TypedArgs'Unds'EventArgs.yaml
LblisChainIDCell	LblisChainIDCell.yaml
Lbl'Hash'decodeLengthPrefixLength'LParUndsCommUndsCommUndsCommUndsRParUnds'SERIALIZATION'Unds'LengthPrefix'Unds'LengthPrefixType'Unds'Bytes'Unds'Int'Unds'Int	Lbl'Hash'decodeLengthPrefixLength'LParUndsCommUndsCommUndsCommUndsRParUnds'SERIALIZATION'Unds'LengthPrefix'Unds'LengthPrefixType'Unds'Bytes'Unds'Int'Unds'Int.yaml
Lbl'Unds'-Int'Unds'	Lbl'Unds'-Int'Unds'.yaml
LblpadRightBytes'LParUndsCommUndsCommUndsRParUnds'BYTES-HOOKED'Unds'Bytes'Unds'Bytes'Unds'Int'Unds'Int	LblpadRightBytes'LParUndsCommUndsCommUndsRParUnds'BYTES-HOOKED'Unds'Bytes'Unds'Bytes'Unds'Int'Unds'Int.yaml
LblisKConfigVar	LblisKConfigVar.yaml
Lblproject'Coln'AccountsCell	Lblproject'Coln'AccountsCell.yaml
LblisRefundCellOpt	LblisRefundCellOpt.yaml
LblisAddressSetCellOpt	LblisAddressSetCellOpt.yaml
Lbl'Hash'parseHexWord'LParUndsRParUnds'SERIALIZATION'Unds'Int'Unds'String	Lbl'Hash'parseHexWord'LParUndsRParUnds'SERIALIZATION'Unds'Int'Unds'String.yaml
LblisIntList	LblisIntList.yaml
LblinitExpectedAddressCell	LblinitExpectedAddressCell.yaml
Lblmethod'Unds'lib'Perc'forge-std'Perc'src'Perc'Vm	Lblmethod'Unds'lib'Perc'forge-std'Perc'src'Perc'Vm.yaml
Lbl'UndsXor-Perc'Int'UndsUnds'	Lbl'UndsXor-Perc'Int'UndsUnds'.yaml
Lbl'Hash'storageRoot'LParUndsRParUnds'SERIALIZATION'Unds'MerkleTree'Unds'Map	Lbl'Hash'storageRoot'LParUndsRParUnds'SERIALIZATION'Unds'MerkleTree'Unds'Map.yaml
LblinitWithdrawalsRootCell	LblinitWithdrawalsRootCell.yaml
Lblmethod'Unds'lib'Perc'forge-std'Perc'src'Perc'mocks'Perc'MockERC721	Lblmethod'Unds'lib'Perc'forge-std'Perc'src'Perc'mocks'Perc'MockERC721.yaml
LblisGas	LblisGas.yaml
LblinitPreviousHashCell	LblinitPreviousHashCell.yaml
LblisDepthCellOpt	LblisDepthCellOpt.yaml
LblinitModeCell	LblinitModeCell.yaml
Lblproject'Coln'WordStackCellOpt	Lblproject'Coln'WordStackCellOpt.yaml
LblisOpcodeTypeCellOpt	LblisOpcodeTypeCellOpt.yaml
Lblproject'Coln'NewOriginCellOpt	Lblproject'Coln'NewOriginCellOpt.yaml
Lblproject'Coln'IsEventExpectedCell	Lblproject'Coln'IsEventExpectedCell.yaml
Lblproject'Coln'CheatcodesCellOpt	Lblproject'Coln'CheatcodesCellOpt.yaml
LblisGasUsedCell	LblisGasUsedCell.yaml
Lblproject'Coln'S2KlibZModforgeZSubstdZModsrcZModVmSafeContract	Lblproject'Coln'S2KlibZModforgeZSubstdZModsrcZModVmSafeContract.yaml
LblisS2KlibZModforgeZSubstdZModsrcZModScriptMethod	LblisS2KlibZModforgeZSubstdZModsrcZModScriptMethod.yaml
LblisLogCellOpt	LblisLogCellOpt.yaml
Lblproject'Coln'SigRCell	Lblproject'Coln'SigRCell.yaml
Lbl'UndsPlus'Gas'UndsUnds'GAS-SYNTAX'Unds'Gas'Unds'Gas'Unds'Gas	Lbl'UndsPlus'Gas'UndsUnds'GAS-SYNTAX'Unds'Gas'Unds'Gas'Unds'Gas.yaml
LblisIdCellOpt	LblisIdCellOpt.yaml
LblisTxPendingCellOpt	LblisTxPendingCellOpt.yaml
Lblproject'Coln'BlockCellFragment	Lblproject'Coln'BlockCellFragment.yaml
LblinitUseGasCell	LblinitUseGasCell.yaml
Lblproject'Coln'LogsBloomCell	Lblproject'Coln'LogsBloomCell.yaml
LblisOrigStorageCellOpt	LblisOrigStorageCellOpt.yaml
Lblproject'Coln'IsCallWhitelistActiveCell	Lblproject'Coln'IsCallWhitelistActiveCell.yaml
Lblproject'Coln'IsCallWhitelistActiveCellOpt	Lblproject'Coln'IsCallWhitelistActiveCellOpt.yaml
LblsetBloomFilterBits'LParUndsRParUnds'EVM'Unds'Int'Unds'Bytes	LblsetBloomFilterBits'LParUndsRParUnds'EVM'Unds'Int'Unds'Bytes.yaml
LblSha256bytes'LParUndsRParUnds'SERIALIZATION'Unds'String'Unds'Bytes	LblSha256bytes'LParUndsRParUnds'SERIALIZATION'Unds'String'Unds'Bytes.yaml
LblisExitCodeCellOpt	LblisExitCodeCellOpt.yaml
Lblproject'Coln'G2Point	Lblproject'Coln'G2Point.yaml
Lbl'Hash'write'LParUndsCommUndsCommUndsRParUnds'EVM-TYPES'Unds'Bytes'Unds'Bytes'Unds'Int'Unds'Int	Lbl'Hash'write'LParUndsCommUndsCommUndsRParUnds'EVM-TYPES'Unds'Bytes'Unds'Bytes'Unds'Int'Unds'Int.yaml
LblisKResult	LblisKResult.yaml
Lblmethod'Unds'lib'Perc'forge-std'Perc'src'Perc'stdError	Lblmethod'Unds'lib'Perc'forge-std'Perc'src'Perc'stdError.yaml
Lblproject'Coln'OpcodeType	Lblproject'Coln'OpcodeType.yaml
LblisS2KtestZModCounterTestContract	LblisS2KtestZModCounterTestContract.yaml
LblisIsEventExpectedCellOpt	LblisIsEventExpectedCellOpt.yaml
LblinitIsOpcodeExpectedCell	LblinitIsOpcodeExpectedCell.yaml
Lblproject'Coln'BinStackOp	Lblproject'Coln'BinStackOp.yaml
LblisOrigStorageCell	LblisOrigStorageCell.yaml
Lbl'Unds'xorBool'Unds'	Lbl'Unds'xorBool'Unds'.yaml
Lblproject'Coln'WhitelistCellOpt	Lblproject'Coln'WhitelistCellOpt.yaml
Lblproject'Coln'DynamicFeeTxData'LParUndsCommUndsCommUndsCommUndsCommUndsCommUndsCommUndsCommUndsCommUndsRParUnds'EVM-TYPES'Unds'DynamicFeeTx'Unds'Int'Unds'Int'Unds'Int'Unds'Int'Unds'Account'Unds'Int'Unds'Bytes'Unds'Int'Unds'JSONs'Coln'nonce	Lblproject'Coln'DynamicFeeTxData'LParUndsCommUndsCommUndsCommUndsCommUndsCommUndsCommUndsCommUndsCommUndsRParUnds'EVM-TYPES'Unds'DynamicFeeTx'Unds'Int'Unds'Int'Unds'Int'Unds'Int'Unds'Account'Unds'Int'Unds'Bytes'Unds'Int'Unds'JSONs'Coln'nonc1001.yaml
LblBN128AtePairing'LParUndsCommUndsRParUnds'KRYPTO'Unds'Bool'Unds'List'Unds'List	LblBN128AtePairing'LParUndsCommUndsRParUnds'KRYPTO'Unds'Bool'Unds'List'Unds'List.yaml
Lblproject'Coln'PrankCell	Lblproject'Coln'PrankCell.yaml
Lblproject'Coln'AddressSetCell	Lblproject'Coln'AddressSetCell.yaml
LblinitInterimStatesCell	LblinitInterimStatesCell.yaml
Lbl'Unds'-Word'UndsUnds'EVM-TYPES'Unds'Int'Unds'Int'Unds'Int	Lbl'Unds'-Word'UndsUnds'EVM-TYPES'Unds'Int'Unds'Int'Unds'Int.yaml
LblisWordStack	LblisWordStack.yaml
LblisBlockCellOpt	LblisBlockCellOpt.yaml
Lblproject'Coln'String	Lblproject'Coln'String.yaml
Lblproject'Coln'WhitelistCellFragment	Lblproject'Coln'WhitelistCellFragment.yaml
Lblkeys'Unds'list'LParUndsRParUnds'MAP'Unds'List'Unds'Map	Lblkeys'Unds'list'LParUndsRParUnds'MAP'Unds'List'Unds'Map.yaml
Lblproject'Coln'MessageCellMap	Lblproject'Coln'MessageCellMap.yaml
Lblproject'Coln'EvmCellOpt	Lblproject'Coln'EvmCellOpt.yaml
Lblproject'Coln'CallSixOp	Lblproject'Coln'CallSixOp.yaml
Lblproject'Coln'GeneratedTopCell	Lblproject'Coln'GeneratedTopCell.yaml
LblisOpcodeTypeCell	LblisOpcodeTypeCell.yaml
LblisBlockNonceCellOpt	LblisBlockNonceCellOpt.yaml
Lblproject'Coln'TransactionsRootCellOpt	Lblproject'Coln'TransactionsRootCellOpt.yaml
LblRipEmd160bytes'LParUndsRParUnds'SERIALIZATION'Unds'String'Unds'Bytes	LblRipEmd160bytes'LParUndsRParUnds'SERIALIZATION'Unds'String'Unds'Bytes.yaml
LblinitMessageCell	LblinitMessageCell.yaml
Lblproject'Coln'StorageSlotSetCell	Lblproject'Coln'StorageSlotSetCell.yaml
Lblproject'Coln'ExpectedOpcodeCell	Lblproject'Coln'ExpectedOpcodeCell.yaml
Lbl'Hash'widthOpCode'LParUndsRParUnds'EVM'Unds'Int'Unds'Int	Lbl'Hash'widthOpCode'LParUndsRParUnds'EVM'Unds'Int'Unds'Int.yaml
LblinitExpectedDepthCell	LblinitExpectedDepthCell.yaml
LblisS2KscriptZModCounterScriptMethod	LblisS2KscriptZModCounterScriptMethod.yaml
Lblproject'Coln'StorageCellOpt	Lblproject'Coln'StorageCellOpt.yaml
Lblproject'Coln'PushOp	Lblproject'Coln'PushOp.yaml
LblMap'Coln'update	LblMap'Coln'update.yaml
Lblproject'Coln'CheckedTopicsCellOpt	Lblproject'Coln'CheckedTopicsCellOpt.yaml
LblisExitCodeCell	LblisExitCodeCell.yaml
Lbl'Hash'getTypedArgs'LParUndsRParUnds'EVM-ABI'Unds'TypedArgs'Unds'EventArgs	Lbl'Hash'getTypedArgs'LParUndsRParUnds'EVM-ABI'Unds'TypedArgs'Unds'EventArgs.yaml
LblisDataCell	LblisDataCell.yaml
LblisCallOp	LblisCallOp.yaml
LblisValueCell	LblisValueCell.yaml
Lbl'Hash'merkleExtensionSplitter'LParUndsCommUndsCommUndsCommUndsCommUndsRParUnds'SERIALIZATION'Unds'MerkleTree'Unds'Bytes'Unds'Bytes'Unds'MerkleTree'Unds'Bytes'Unds'String	Lbl'Hash'merkleExtensionSplitter'LParUndsCommUndsCommUndsCommUndsCommUndsRParUnds'SERIALIZATION'Unds'MerkleTree'Unds'Bytes'Unds'Bytes'Unds'MerkleTree'Unds'Bytes'Unds'String.yaml
Lblproject'Coln'ExtraDataCell	Lblproject'Coln'ExtraDataCell.yaml
Lbl'Hash'rlpEncodeLength'LParUndsCommUndsCommUndsRParUnds'SERIALIZATION'Unds'Bytes'Unds'Bytes'Unds'Int'Unds'Bytes	Lbl'Hash'rlpEncodeLength'LParUndsCommUndsCommUndsRParUnds'SERIALIZATION'Unds'Bytes'Unds'Bytes'Unds'Int'Unds'Bytes.yaml
Lbl'Hash'powByteLen'LParUndsRParUnds'BUF'Unds'Int'Unds'Int	Lbl'Hash'powByteLen'LParUndsRParUnds'BUF'Unds'Int'Unds'Int.yaml
Lblproject'Coln'LegacyTxData'LParUndsCommUndsCommUndsCommUndsCommUndsCommUndsRParUnds'EVM-TYPES'Unds'LegacyTx'Unds'Int'Unds'Int'Unds'Int'Unds'Account'Unds'Int'Unds'Bytes'Coln'nonce	Lblproject'Coln'LegacyTxData'LParUndsCommUndsCommUndsCommUndsCommUndsCommUndsRParUnds'EVM-TYPES'Unds'LegacyTx'Unds'Int'Unds'Int'Unds'Int'Unds'Account'Unds'Int'Unds'Bytes'Coln'nonce.yaml
LblcountAllOccurrences'LParUndsCommUndsRParUnds'STRING-COMMON'Unds'Int'Unds'String'Unds'String	LblcountAllOccurrences'LParUndsCommUndsRParUnds'STRING-COMMON'Unds'Int'Unds'String'Unds'String.yaml
Lblproject'Coln'KevmCell	Lblproject'Coln'KevmCell.yaml
LblabsInt'LParUndsRParUnds'INT-COMMON'Unds'Int'Unds'Int	LblabsInt'LParUndsRParUnds'INT-COMMON'Unds'Int'Unds'Int.yaml
LblisInterimStatesCellOpt	LblisInterimStatesCellOpt.yaml
LblisCheatcodesCellFragment	LblisCheatcodesCellFragment.yaml
Lblproject'Coln'NonceCellOpt	Lblproject'Coln'NonceCellOpt.yaml
Lblproject'Coln'SubstateLogEntry	Lblproject'Coln'SubstateLogEntry.yaml
LblinitIsCallWhitelistActiveCell	LblinitIsCallWhitelistActiveCell.yaml
LblFloat2String'LParUndsRParUnds'STRING-COMMON'Unds'String'Unds'Float	LblFloat2String'LParUndsRParUnds'STRING-COMMON'Unds'String'Unds'Float.yaml
LblisFoundryCellFragment	LblisFoundryCellFragment.yaml
Lblproject'Coln'PrevOriginCellOpt	Lblproject'Coln'PrevOriginCellOpt.yaml
Lblproject'Coln'TxAccessCell	Lblproject'Coln'TxAccessCell.yaml
LblisTouchedAccountsCell	LblisTouchedAccountsCell.yaml
LblisS2KlibZModforgeZSubstdZModsrcZModVmSafeMethod	LblisS2KlibZModforgeZSubstdZModsrcZModVmSafeMethod.yaml
Lblmethod'Unds'test'Perc'CounterTest	Lblmethod'Unds'test'Perc'CounterTest.yaml
Lblproject'Coln'S2KlibZModforgeZSubstdZModsrcZModmocksZModMockERC721Method	Lblproject'Coln'S2KlibZModforgeZSubstdZModsrcZModmocksZModMockERC721Method.yaml
LblisKCellOpt	LblisKCellOpt.yaml
Lblproject'Coln'ExceptionalStatusCode	Lblproject'Coln'ExceptionalStatusCode.yaml
LblbitRangeInt'LParUndsCommUndsCommUndsRParUnds'INT-COMMON'Unds'Int'Unds'Int'Unds'Int'Unds'Int	LblbitRangeInt'LParUndsCommUndsCommUndsRParUnds'INT-COMMON'Unds'Int'Unds'Int'Unds'Int'Unds'Int.yaml
Lblproject'Coln'CallDataCellOpt	Lblproject'Coln'CallDataCellOpt.yaml
LblisIsStorageWhitelistActiveCellOpt	LblisIsStorageWhitelistActiveCellOpt.yaml
LblinitOmmerBlockHeadersCell	LblinitOmmerBlockHeadersCell.yaml
LblinitSelfDestructCell	LblinitSelfDestructCell.yaml
LblisTxNonceCellOpt	LblisTxNonceCellOpt.yaml
Lbl'UndsPlus'String'UndsUnds'STRING-COMMON'Unds'String'Unds'String'Unds'String	Lbl'UndsPlus'String'UndsUnds'STRING-COMMON'Unds'String'Unds'String'Unds'String.yaml
Lbl'Hash'newMultComplexity'LParUndsRParUnds'GAS-FEES'Unds'Int'Unds'Int	Lbl'Hash'newMultComplexity'LParUndsRParUnds'GAS-FEES'Unds'Int'Unds'Int.yaml
Lblproject'Coln'ValueCell	Lblproject'Coln'ValueCell.yaml
Lblproject'Coln'AccessListTxData'LParUndsCommUndsCommUndsCommUndsCommUndsCommUndsCommUndsCommUndsRParUnds'EVM-TYPES'Unds'AccessListTx'Unds'Int'Unds'Int'Unds'Int'Unds'Account'Unds'Int'Unds'Bytes'Unds'Int'Unds'JSONs'Coln'data	Lblproject'Coln'AccessListTxData'LParUndsCommUndsCommUndsCommUndsCommUndsCommUndsCommUndsCommUndsRParUnds'EVM-TYPES'Unds'AccessListTx'Unds'Int'Unds'Int'Unds'Int'Unds'Account'Unds'Int'Unds'Bytes'Unds'Int'Unds'JSONs'Coln'data.yaml
Lblproject'Coln'KItem	Lblproject'Coln'KItem.yaml
Lbl'UndsColnUndsUnds'EVM-TYPES'Unds'Bytes'Unds'Int'Unds'Bytes	Lbl'UndsColnUndsUnds'EVM-TYPES'Unds'Bytes'Unds'Int'Unds'Bytes.yaml
LblisLegacyTx	LblisLegacyTx.yaml
LblinitGasUsedCell	LblinitGasUsedCell.yaml
Lblproject'Coln'LegacyTxData'LParUndsCommUndsCommUndsCommUndsCommUndsCommUndsRParUnds'EVM-TYPES'Unds'LegacyTx'Unds'Int'Unds'Int'Unds'Int'Unds'Account'Unds'Int'Unds'Bytes'Coln'data	Lblproject'Coln'LegacyTxData'LParUndsCommUndsCommUndsCommUndsCommUndsCommUndsRParUnds'EVM-TYPES'Unds'LegacyTx'Unds'Int'Unds'Int'Unds'Int'Unds'Account'Unds'Int'Unds'Bytes'Coln'data.yaml
Lblproject'Coln'EvmCell	Lblproject'Coln'EvmCell.yaml
Lbl'Hash'rlpDecodeList'LParUndsCommUndsCommUndsRParUnds'SERIALIZATION'Unds'JSONs'Unds'Bytes'Unds'Int'Unds'LengthPrefix	Lbl'Hash'rlpDecodeList'LParUndsCommUndsCommUndsRParUnds'SERIALIZATION'Unds'JSONs'Unds'Bytes'Unds'Int'Unds'LengthPrefix.yaml
LblisCheatcodesCellOpt	LblisCheatcodesCellOpt.yaml
LblM3'Coln'2048'LParUndsRParUnds'EVM'Unds'Int'Unds'Bytes	LblM3'Coln'2048'LParUndsRParUnds'EVM'Unds'Int'Unds'Bytes.yaml
LblisS2KlibZModkontrolZSubcheatcodesZModsrcZModKontrolCheatsBaseContract	LblisS2KlibZModkontrolZSubcheatcodesZModsrcZModKontrolCheatsBaseContract.yaml
LblHPEncodeAux'LParUndsRParUnds'SERIALIZATION'Unds'Int'Unds'Int	LblHPEncodeAux'LParUndsRParUnds'SERIALIZATION'Unds'Int'Unds'Int.yaml
LblisFoundryField	LblisFoundryField.yaml
LblinitOmmersHashCell	LblinitOmmersHashCell.yaml
Lbl'Unds's'-LT-'Word'UndsUnds'EVM-TYPES'Unds'Int'Unds'Int'Unds'Int	Lbl'Unds's'-LT-'Word'UndsUnds'EVM-TYPES'Unds'Int'Unds'Int'Unds'Int.yaml
Lblproject'Coln'BlockhashesCell	Lblproject'Coln'BlockhashesCell.yaml
LblinitEvmCell	LblinitEvmCell.yaml
LblaccountEmpty	LblaccountEmpty.yaml
Lblcontract'Unds'access'Unds'hash	Lblcontract'Unds'access'Unds'hash.yaml
LblisTxGasLimitCell	LblisTxGasLimitCell.yaml
LblisBalanceCellOpt	LblisBalanceCellOpt.yaml
LblinitReceiptsRootCell	LblinitReceiptsRootCell.yaml
LblinitTxTypeCell	LblinitTxTypeCell.yaml
Lblproject'Coln'PreviousHashCellOpt	Lblproject'Coln'PreviousHashCellOpt.yaml
Lblproject'Coln'InterimStatesCell	Lblproject'Coln'InterimStatesCell.yaml
Lblproject'Coln'AccessListTxData'LParUndsCommUndsCommUndsCommUndsCommUndsCommUndsCommUndsCommUndsRParUnds'EVM-TYPES'Unds'AccessListTx'Unds'Int'Unds'Int'Unds'Int'Unds'Account'Unds'Int'Unds'Bytes'Unds'Int'Unds'JSONs'Coln'gasPrice	Lblproject'Coln'AccessListTxData'LParUndsCommUndsCommUndsCommUndsCommUndsCommUndsCommUndsCommUndsRParUnds'EVM-TYPES'Unds'AccessListTx'Unds'Int'Unds'Int'Unds'Int'Unds'Account'Unds'Int'Unds'Bytes'Unds'Int'Unds'JSONs'Coln'gasPrice.yaml
Lbl'Hash'precompiledAccountsMap'LParUndsRParUnds'SERIALIZATION'Unds'Map'Unds'Set	Lbl'Hash'precompiledAccountsMap'LParUndsRParUnds'SERIALIZATION'Unds'Map'Unds'Set.yaml
LblisAccessedAccountsCell	LblisAccessedAccountsCell.yaml
Lblmethod'Unds'lib'Perc'forge-std'Perc'lib'Perc'ds-test'Perc'src'Perc'DSTest	Lblmethod'Unds'lib'Perc'forge-std'Perc'lib'Perc'ds-test'Perc'src'Perc'DSTest.yaml
Lblproject'Coln'TxOrderCellOpt	Lblproject'Coln'TxOrderCellOpt.yaml
LblisBool	LblisBool.yaml
LblisKevmCellFragment	LblisKevmCellFragment.yaml
LblisAccountCellMap	LblisAccountCellMap.yaml
Lbl'Hash'asByteStack'LParUndsRParUnds'EVM-TYPES'Unds'Bytes'Unds'Int	Lbl'Hash'asByteStack'LParUndsRParUnds'EVM-TYPES'Unds'Bytes'Unds'Int.yaml
LblisCallStateCellFragment	LblisCallStateCellFragment.yaml
Lblproject'Coln'TxGasPriceCell	Lblproject'Coln'TxGasPriceCell.yaml
LblisS2KlibZModforgeZSubstdZModlibZModdsZSubtestZModsrcZModDSTestContract	LblisS2KlibZModforgeZSubstdZModlibZModdsZSubtestZModsrcZModDSTestContract.yaml
LblisEthereumCommand	LblisEthereumCommand.yaml
Lblproject'Coln'ExpectedReasonCell	Lblproject'Coln'ExpectedReasonCell.yaml
Lblproject'Coln'S2KlibZModkontrolZSubcheatcodesZModsrcZModKontrolCheatsBaseMethod	Lblproject'Coln'S2KlibZModkontrolZSubcheatcodesZModsrcZModKontrolCheatsBaseMethod.yaml
Lbl'Hash'isValidCode'LParUndsCommUndsRParUnds'EVM'Unds'Bool'Unds'Bytes'Unds'Schedule	Lbl'Hash'isValidCode'LParUndsCommUndsRParUnds'EVM'Unds'Bool'Unds'Bytes'Unds'Schedule.yaml
Lblproject'Coln'StatusCodeCell	Lblproject'Coln'StatusCodeCell.yaml
LblisS2KlibZModforgeZSubstdZModsrcZModVmMethod	LblisS2KlibZModforgeZSubstdZModsrcZModVmMethod.yaml
Lbl'Hash'allBut64th'LParUndsRParUnds'GAS-FEES'Unds'Int'Unds'Int	Lbl'Hash'allBut64th'LParUndsRParUnds'GAS-FEES'Unds'Int'Unds'Int.yaml
Lbl'Stop'AccountCellMap	Lbl'Stop'AccountCellMap.yaml
LblisExtraDataCell	LblisExtraDataCell.yaml
LblisTernStackOp	LblisTernStackOp.yaml
Lblproject'Coln'ModeCellOpt	Lblproject'Coln'ModeCellOpt.yaml
Lbl'UndsEqlsSlshEqls'K'Unds'	Lbl'UndsEqlsSlshEqls'K'Unds'.yaml
Lbl'Hash'entriesLT'LParUndsCommUndsRParUnds'JSON-EXT'Unds'JSONs'Unds'String'Unds'JSONs	Lbl'Hash'entriesLT'LParUndsCommUndsRParUnds'JSON-EXT'Unds'JSONs'Unds'String'Unds'JSONs.yaml
LblisDifficultyCell	LblisDifficultyCell.yaml
Lblproject'Coln'S2KtestZModCounterTestMethod	Lblproject'Coln'S2KtestZModCounterTestMethod.yaml
LblisList	LblisList.yaml
LblisIsOpcodeExpectedCellOpt	LblisIsOpcodeExpectedCellOpt.yaml
LblisAccessedAccountsCellOpt	LblisAccessedAccountsCellOpt.yaml
LblisEventArgs	LblisEventArgs.yaml
Lbl'Hash'lenOfHead'LParUndsRParUnds'EVM-ABI'Unds'Int'Unds'TypedArg	Lbl'Hash'lenOfHead'LParUndsRParUnds'EVM-ABI'Unds'Int'Unds'TypedArg.yaml
Lbl'UndsSlsh'Word'UndsUnds'EVM-TYPES'Unds'Int'Unds'Int'Unds'Int	Lbl'UndsSlsh'Word'UndsUnds'EVM-TYPES'Unds'Int'Unds'Int'Unds'Int.yaml
LblisFloat	LblisFloat.yaml
LblisMaybeOpCode	LblisMaybeOpCode.yaml
Lblproject'Coln'NumberCellOpt	Lblproject'Coln'NumberCellOpt.yaml
Lbl'Hash'cleanBranchMap'LParUndsRParUnds'SERIALIZATION'Unds'Map'Unds'Map	Lbl'Hash'cleanBranchMap'LParUndsRParUnds'SERIALIZATION'Unds'Map'Unds'Map.yaml
LblCinitcode'LParUndsCommUndsRParUnds'GAS-FEES'Unds'Int'Unds'Schedule'Unds'Int	LblCinitcode'LParUndsCommUndsRParUnds'GAS-FEES'Unds'Int'Unds'Schedule'Unds'Int.yaml
LblisEventArg	LblisEventArg.yaml
Lbl'Hash'parseMap'LParUndsRParUnds'SERIALIZATION'Unds'Map'Unds'JSON	Lbl'Hash'parseMap'LParUndsRParUnds'SERIALIZATION'Unds'Map'Unds'JSON.yaml
Lbl'Hash'bufStrict'LParUndsCommUndsRParUnds'BUF-SYNTAX'Unds'Bytes'Unds'Int'Unds'Int	Lbl'Hash'bufStrict'LParUndsCommUndsRParUnds'BUF-SYNTAX'Unds'Bytes'Unds'Int'Unds'Int.yaml
LblblockHeaderHash	LblblockHeaderHash.yaml
Lblproject'Coln'S2KlibZModforgeZSubstdZModsrcZModTestBaseContract	Lblproject'Coln'S2KlibZModforgeZSubstdZModsrcZModTestBaseContract.yaml
Lbl'Hash'intMap2StorageMap'LParUndsRParUnds'SERIALIZATION'Unds'Map'Unds'Map	Lbl'Hash'intMap2StorageMap'LParUndsRParUnds'SERIALIZATION'Unds'Map'Unds'Map.yaml
LblECDSASignbytes'LParUndsCommUndsRParUnds'SERIALIZATION'Unds'String'Unds'Bytes'Unds'Bytes	LblECDSASignbytes'LParUndsCommUndsRParUnds'SERIALIZATION'Unds'String'Unds'Bytes'Unds'Bytes.yaml
Lbl'Unds'up'Slsh'Int'UndsUnds'EVM-TYPES'Unds'Int'Unds'Int'Unds'Int	Lbl'Unds'up'Slsh'Int'UndsUnds'EVM-TYPES'Unds'Int'Unds'Int'Unds'Int.yaml
Lblproject'Coln'PrankCellFragment	Lblproject'Coln'PrankCellFragment.yaml
LblinitNewOriginCell	LblinitNewOriginCell.yaml
Lbl'Hash'checkTopics'LParUndsCommUndsCommUndsRParUnds'FOUNDRY-CHEAT-CODES'Unds'Bool'Unds'List'Unds'List'Unds'List	Lbl'Hash'checkTopics'LParUndsCommUndsCommUndsRParUnds'FOUNDRY-CHEAT-CODES'Unds'Bool'Unds'List'Unds'List'Unds'List.yaml
Lblproject'Coln'EndStatusCode	Lblproject'Coln'EndStatusCode.yaml
LblisValidPoint'LParUndsRParUnds'KRYPTO'Unds'Bool'Unds'G2Point	LblisValidPoint'LParUndsRParUnds'KRYPTO'Unds'Bool'Unds'G2Point.yaml
LblisSelfDestructCell	LblisSelfDestructCell.yaml
Lblproject'Coln'ScheduleCell	Lblproject'Coln'ScheduleCell.yaml
Lblproject'Coln'S2KlibZModforgeZSubstdZModsrcZModCommonBaseContract	Lblproject'Coln'S2KlibZModforgeZSubstdZModsrcZModCommonBaseContract.yaml
LblCxfer'LParUndsCommUndsRParUnds'GAS-FEES'Unds'Int'Unds'Schedule'Unds'Int	LblCxfer'LParUndsCommUndsRParUnds'GAS-FEES'Unds'Int'Unds'Schedule'Unds'Int.yaml
Lbl'Stop'Bytes'Unds'BYTES-HOOKED'Unds'Bytes	Lbl'Stop'Bytes'Unds'BYTES-HOOKED'Unds'Bytes.yaml
Lblproject'Coln'PrevCallerCell	Lblproject'Coln'PrevCallerCell.yaml
LblinitLogCell	LblinitLogCell.yaml
Lbl'Hash'padByte'LParUndsRParUnds'SERIALIZATION'Unds'String'Unds'String	Lbl'Hash'padByte'LParUndsRParUnds'SERIALIZATION'Unds'String'Unds'String.yaml
LblisNetworkCellFragment	LblisNetworkCellFragment.yaml
Lblproject'Coln'TxGasPriceCellOpt	Lblproject'Coln'TxGasPriceCellOpt.yaml
LblisAccount	LblisAccount.yaml
Lblproject'Coln'LegacyProtectedTxData'LParUndsCommUndsCommUndsCommUndsCommUndsCommUndsCommUndsRParUnds'EVM-TYPES'Unds'LegacyTx'Unds'Int'Unds'Int'Unds'Int'Unds'Account'Unds'Int'Unds'Bytes'Unds'Int'Coln'gasLimit	Lblproject'Coln'LegacyProtectedTxData'LParUndsCommUndsCommUndsCommUndsCommUndsCommUndsCommUndsRParUnds'EVM-TYPES'Unds'LegacyTx'Unds'Int'Unds'Int'Unds'Int'Unds'Account'Unds'Int'Unds'Bytes'Unds'Int'Coln'gasLimit.yaml
LbllengthBytes'LParUndsRParUnds'BYTES-HOOKED'Unds'Int'Unds'Bytes	LbllengthBytes'LParUndsRParUnds'BYTES-HOOKED'Unds'Int'Unds'Bytes.yaml
Lbl'UndsPerc'Word'UndsUnds'EVM-TYPES'Unds'Int'Unds'Int'Unds'Int	Lbl'UndsPerc'Word'UndsUnds'EVM-TYPES'Unds'Int'Unds'Int'Unds'Int.yaml
LblqsortJSONs'LParUndsRParUnds'JSON-EXT'Unds'JSONs'Unds'JSONs	LblqsortJSONs'LParUndsRParUnds'JSON-EXT'Unds'JSONs'Unds'JSONs.yaml
Lbl'Unds'List'Unds'	Lbl'Unds'List'Unds'.yaml
Lblproject'Coln'JSON	Lblproject'Coln'JSON.yaml
LblisOutputCell	LblisOutputCell.yaml
LblisSelfDestructCellOpt	LblisSelfDestructCellOpt.yaml
Lbl'Hash'entriesGE'LParUndsCommUndsRParUnds'JSON-EXT'Unds'JSONs'Unds'String'Unds'JSONs	Lbl'Hash'entriesGE'LParUndsCommUndsRParUnds'JSON-EXT'Unds'JSONs'Unds'String'Unds'JSONs.yaml
LblisS2KlibZModforgeZSubstdZModsrcZModmocksZModIERC721TokenReceiverContract	LblisS2KlibZModforgeZSubstdZModsrcZModmocksZModIERC721TokenReceiverContract.yaml
LblisGasCell	LblisGasCell.yaml
LblinitExtraDataCell	LblinitExtraDataCell.yaml
Lblproject'Coln'S2KlibZModforgeZSubstdZModsrcZModTestMethod	Lblproject'Coln'S2KlibZModforgeZSubstdZModsrcZModTestMethod.yaml
LblCgascap'LParUndsCommUndsCommUndsCommUndsRParUnds'GAS-FEES'Unds'Int'Unds'Schedule'Unds'Int'Unds'Int'Unds'Int	LblCgascap'LParUndsCommUndsCommUndsCommUndsRParUnds'GAS-FEES'Unds'Int'Unds'Schedule'Unds'Int'Unds'Int'Unds'Int.yaml
Lblproject'Coln'KevmCellOpt	Lblproject'Coln'KevmCellOpt.yaml
Lbl'Hash'rlpDecodeTransaction'LParUndsRParUnds'SERIALIZATION'Unds'JSONs'Unds'Bytes	Lbl'Hash'rlpDecodeTransaction'LParUndsRParUnds'SERIALIZATION'Unds'JSONs'Unds'Bytes.yaml
LblisJSON	LblisJSON.yaml
Lblproject'Coln'CheatcodesCell	Lblproject'Coln'CheatcodesCell.yaml
Lblproject'Coln'ToCellOpt	Lblproject'Coln'ToCellOpt.yaml
Lbl'Hash'emptyContractRLP'Unds'SERIALIZATION'Unds'Bytes	Lbl'Hash'emptyContractRLP'Unds'SERIALIZATION'Unds'Bytes.yaml
LblisActiveCellOpt	LblisActiveCellOpt.yaml
LblisGasPriceCellOpt	LblisGasPriceCellOpt.yaml
Lbl'Hash'decodeLengthPrefix'LParUndsCommUndsCommUndsRParUnds'SERIALIZATION'Unds'LengthPrefix'Unds'Bytes'Unds'Int'Unds'Int	Lbl'Hash'decodeLengthPrefix'LParUndsCommUndsCommUndsRParUnds'SERIALIZATION'Unds'LengthPrefix'Unds'Bytes'Unds'Int'Unds'Int.yaml
LblinitNetworkCell	LblinitNetworkCell.yaml
Lblproject'Coln'S2KscriptZModCounterScriptMethod	Lblproject'Coln'S2KscriptZModCounterScriptMethod.yaml
Lblproject'Coln'ExpectEmitCell	Lblproject'Coln'ExpectEmitCell.yaml
LblinitTxAccessCell	LblinitTxAccessCell.yaml
LblisDataCellOpt	LblisDataCellOpt.yaml
Lblmethod'Unds'script'Perc'CounterScript	Lblmethod'Unds'script'Perc'CounterScript.yaml
LblisOmmerBlockHeadersCellOpt	LblisOmmerBlockHeadersCellOpt.yaml
Lbl'Hash'lookup'LParUndsCommUndsRParUnds'EVM-TYPES'Unds'Int'Unds'Map'Unds'Int	Lbl'Hash'lookup'LParUndsCommUndsRParUnds'EVM-TYPES'Unds'Int'Unds'Map'Unds'Int.yaml
Lbl'Unds-GT-Eqls'String'UndsUnds'STRING-COMMON'Unds'Bool'Unds'String'Unds'String	Lbl'Unds-GT-Eqls'String'UndsUnds'STRING-COMMON'Unds'Bool'Unds'String'Unds'String.yaml
LblisUnStackOp	LblisUnStackOp.yaml
LblisEthereumCellOpt	LblisEthereumCellOpt.yaml
LblisTxPriorityFeeCellOpt	LblisTxPriorityFeeCellOpt.yaml
Lblproject'Coln'NewCallerCellOpt	Lblproject'Coln'NewCallerCellOpt.yaml
LblisCheckedDataCell	LblisCheckedDataCell.yaml
LblisWhitelistCellFragment	LblisWhitelistCellFragment.yaml
Lblproject'Coln'UseGasCellOpt	Lblproject'Coln'UseGasCellOpt.yaml
Lblproject'Coln'MessagesCell	Lblproject'Coln'MessagesCell.yaml
Lblproject'Coln'S2KlibZModforgeZSubstdZModsrcZModmocksZModMockERC20Contract	Lblproject'Coln'S2KlibZModforgeZSubstdZModsrcZModmocksZModMockERC20Contract.yaml
Lblproject'Coln'AccountCell	Lblproject'Coln'AccountCell.yaml
Lbl'Hash'merkleExtensionBuilderAux'LParUndsCommUndsCommUndsCommUndsCommUndsRParUnds'SERIALIZATION'Unds'MerkleTree'Unds'Bytes'Unds'Bytes'Unds'String'Unds'Bytes'Unds'String	Lbl'Hash'merkleExtensionBuilderAux'LParUndsCommUndsCommUndsCommUndsCommUndsRParUnds'SERIALIZATION'Unds'MerkleTree'Unds'Bytes'Unds'Bytes'Unds'String'Unds'Bytes'Unds'String.yaml
LblisWithdrawalsRootCell	LblisWithdrawalsRootCell.yaml
LblisSigVCell	LblisSigVCell.yaml
Lblproject'Coln'CallStackCell	Lblproject'Coln'CallStackCell.yaml
LblinitGeneratedCounterCell	LblinitGeneratedCounterCell.yaml
Lblproject'Coln'K	Lblproject'Coln'K.yaml
LblisStateRootCell	LblisStateRootCell.yaml
Lblproject'Coln'AccountsCellOpt	Lblproject'Coln'AccountsCellOpt.yaml
LblblockHeaderHashBaseFee	LblblockHeaderHashBaseFee.yaml
Lbl'Hash'byteify'LParUndsRParUnds'SERIALIZATION'Unds'Bytes'Unds'Bytes	Lbl'Hash'byteify'LParUndsRParUnds'SERIALIZATION'Unds'Bytes'Unds'Bytes.yaml
LblisAccessedStorageCell	LblisAccessedStorageCell.yaml
LblisExpectedReasonCell	LblisExpectedReasonCell.yaml
LblinitCallerCell	LblinitCallerCell.yaml
Lblabs'LParUndsRParUnds'EVM-TYPES'Unds'Int'Unds'Int	Lblabs'LParUndsRParUnds'EVM-TYPES'Unds'Int'Unds'Int.yaml
LblisTypedArg	LblisTypedArg.yaml
LblreplaceAll'LParUndsCommUndsCommUndsRParUnds'STRING-COMMON'Unds'String'Unds'String'Unds'String'Unds'String	LblreplaceAll'LParUndsCommUndsCommUndsRParUnds'STRING-COMMON'Unds'String'Unds'String'Unds'String'Unds'String.yaml
LblBytes2String'LParUndsRParUnds'BYTES-HOOKED'Unds'String'Unds'Bytes	LblBytes2String'LParUndsRParUnds'BYTES-HOOKED'Unds'String'Unds'Bytes.yaml
LblisTxPriorityFeeCell	LblisTxPriorityFeeCell.yaml
Lbl'UndsSlsh'sWord'UndsUnds'EVM-TYPES'Unds'Int'Unds'Int'Unds'Int	Lbl'UndsSlsh'sWord'UndsUnds'EVM-TYPES'Unds'Int'Unds'Int'Unds'Int.yaml
LblisValueCellOpt	LblisValueCellOpt.yaml
Lblproject'Coln'QuadStackOp	Lblproject'Coln'QuadStackOp.yaml
Lblproject'Coln'Gas	Lblproject'Coln'Gas.yaml
LblisSubstateLogEntry	LblisSubstateLogEntry.yaml
LblinitExpectedRevertCell	LblinitExpectedRevertCell.yaml
LblisStorageSlot	LblisStorageSlot.yaml
LblpadLeftBytes'LParUndsCommUndsCommUndsRParUnds'BYTES-HOOKED'Unds'Bytes'Unds'Bytes'Unds'Int'Unds'Int	LblpadLeftBytes'LParUndsCommUndsCommUndsRParUnds'BYTES-HOOKED'Unds'Bytes'Unds'Bytes'Unds'Int'Unds'Int.yaml
Lblproject'Coln'EthereumSimulation	Lblproject'Coln'EthereumSimulation.yaml
LblisCallerCellOpt	LblisCallerCellOpt.yaml
LblisTxOrderCell	LblisTxOrderCell.yaml
Lblkeys'LParUndsRParUnds'MAP'Unds'Set'Unds'Map	Lblkeys'LParUndsRParUnds'MAP'Unds'Set'Unds'Map.yaml
LblisS2KlibZModforgeZSubstdZModsrcZModStdUtilsContract	LblisS2KlibZModforgeZSubstdZModsrcZModStdUtilsContract.yaml
LblisString	LblisString.yaml
Lblproject'Coln'DataCellOpt	Lblproject'Coln'DataCellOpt.yaml
Lbl'Hash'replicateAux'LParUndsCommUndsCommUndsRParUnds'EVM-TYPES'Unds'WordStack'Unds'Int'Unds'Int'Unds'WordStack	Lbl'Hash'replicateAux'LParUndsCommUndsCommUndsRParUnds'EVM-TYPES'Unds'WordStack'Unds'Int'Unds'Int'Unds'WordStack.yaml
LblisTxNonceCell	LblisTxNonceCell.yaml
LblisIsOpcodeExpectedCell	LblisIsOpcodeExpectedCell.yaml
LblinitStorageSlotSetCell	LblinitStorageSlotSetCell.yaml
LblinitAccessedStorageCell	LblinitAccessedStorageCell.yaml
LblisPrecompiledOp	LblisPrecompiledOp.yaml
Lblproject'Coln'TouchedAccountsCell	Lblproject'Coln'TouchedAccountsCell.yaml
Lbl'Hash'precompiledAccountsMapAux'LParUndsCommUndsRParUnds'SERIALIZATION'Unds'Map'Unds'List'Unds'Map	Lbl'Hash'precompiledAccountsMapAux'LParUndsCommUndsRParUnds'SERIALIZATION'Unds'Map'Unds'List'Unds'Map.yaml
Lbl'Hash'intMap2StorageMapAux'LParUndsCommUndsCommUndsRParUnds'SERIALIZATION'Unds'Map'Unds'Map'Unds'Map'Unds'List	Lbl'Hash'intMap2StorageMapAux'LParUndsCommUndsCommUndsRParUnds'SERIALIZATION'Unds'Map'Unds'Map'Unds'Map'Unds'List.yaml
Lbl'Hash'computeValidJumpDestsWithinBound'LParUndsCommUndsCommUndsRParUnds'EVM'Unds'Set'Unds'Bytes'Unds'Int'Unds'List	Lbl'Hash'computeValidJumpDestsWithinBound'LParUndsCommUndsCommUndsRParUnds'EVM'Unds'Set'Unds'Bytes'Unds'Int'Unds'List.yaml
LblreverseBytes'LParUndsRParUnds'BYTES-HOOKED'Unds'Bytes'Unds'Bytes	LblreverseBytes'LParUndsRParUnds'BYTES-HOOKED'Unds'Bytes'Unds'Bytes.yaml
LblinitPrevOriginCell	LblinitPrevOriginCell.yaml
LblisIsCallWhitelistActiveCellOpt	LblisIsCallWhitelistActiveCellOpt.yaml
Lbl'Hash'unparseData'LParUndsCommUndsRParUnds'SERIALIZATION'Unds'String'Unds'Int'Unds'Int	Lbl'Hash'unparseData'LParUndsCommUndsRParUnds'SERIALIZATION'Unds'String'Unds'Int'Unds'Int.yaml
LblisKCell	LblisKCell.yaml
LblMerkleCheck'LParUndsRParUnds'SERIALIZATION'Unds'MerkleTree'Unds'MerkleTree	LblMerkleCheck'LParUndsRParUnds'SERIALIZATION'Unds'MerkleTree'Unds'MerkleTree.yaml
Lblproject'Coln'OrigStorageCell	Lblproject'Coln'OrigStorageCell.yaml
Lblproject'Coln'ReceiptsRootCellOpt	Lblproject'Coln'ReceiptsRootCellOpt.yaml
LblisSigRCellOpt	LblisSigRCellOpt.yaml
Lblproject'Coln'Bool	Lblproject'Coln'Bool.yaml
LblisNetworkCell	LblisNetworkCell.yaml
LblisNullStackOp	LblisNullStackOp.yaml
LblisSignedness	LblisSignedness.yaml
LblisExpectedDataCellOpt	LblisExpectedDataCellOpt.yaml
Lblproject'Coln'DataCell	Lblproject'Coln'DataCell.yaml
Lbl'Hash'blockHashHeaderBytes	Lbl'Hash'blockHashHeaderBytes.yaml
Lblproject'Coln'WordStack	Lblproject'Coln'WordStack.yaml
LblKeccak256bytes'LParUndsRParUnds'SERIALIZATION'Unds'String'Unds'Bytes	LblKeccak256bytes'LParUndsRParUnds'SERIALIZATION'Unds'String'Unds'Bytes.yaml
Lblproject'Coln'IsRevertExpectedCell	Lblproject'Coln'IsRevertExpectedCell.yaml
LblisModeCell	LblisModeCell.yaml
Lblproject'Coln'OmmerBlockHeadersCellOpt	Lblproject'Coln'OmmerBlockHeadersCellOpt.yaml
Lblproject'Coln'S2KlibZModforgeZSubstdZModsrcZModVmMethod	Lblproject'Coln'S2KlibZModforgeZSubstdZModsrcZModVmMethod.yaml
Lbl'Unds'in'UndsUnds'LIST'Unds'Bool'Unds'KItem'Unds'List	Lbl'Unds'in'UndsUnds'LIST'Unds'Bool'Unds'KItem'Unds'List.yaml
Lblproject'Coln'OriginCellOpt	Lblproject'Coln'OriginCellOpt.yaml
LblisExpectedEventAddressCell	LblisExpectedEventAddressCell.yaml
Lblproject'Coln'PrevOriginCell	Lblproject'Coln'PrevOriginCell.yaml
Lblproject'Coln'ExpectedEventAddressCell	Lblproject'Coln'ExpectedEventAddressCell.yaml
LblinitProgramCell	LblinitProgramCell.yaml
Lblproject'Coln'JumpDestsCellOpt	Lblproject'Coln'JumpDestsCellOpt.yaml
LblinitNewCallerCell	LblinitNewCallerCell.yaml
Lbl'UndsPerc'sWord'UndsUnds'EVM-TYPES'Unds'Int'Unds'Int'Unds'Int	Lbl'UndsPerc'sWord'UndsUnds'EVM-TYPES'Unds'Int'Unds'Int'Unds'Int.yaml
Lbl'Hash'getValue'LParUndsRParUnds'EVM-ABI'Unds'Int'Unds'TypedArg	Lbl'Hash'getValue'LParUndsRParUnds'EVM-ABI'Unds'Int'Unds'TypedArg.yaml
Lbl'UndsEqlsEqls'Word'UndsUnds'EVM-TYPES'Unds'Int'Unds'Int'Unds'Int	Lbl'UndsEqlsEqls'Word'UndsUnds'EVM-TYPES'Unds'Int'Unds'Int'Unds'Int.yaml
LblMerkleUpdate'LParUndsCommUndsCommUndsRParUnds'SERIALIZATION'Unds'MerkleTree'Unds'MerkleTree'Unds'Bytes'Unds'String	LblMerkleUpdate'LParUndsCommUndsCommUndsRParUnds'SERIALIZATION'Unds'MerkleTree'Unds'MerkleTree'Unds'Bytes'Unds'String.yaml
Lblproject'Coln'GeneratedTopCellFragment	Lblproject'Coln'GeneratedTopCellFragment.yaml
Lbl'Unds-GT-Eqls'Int'Unds'	Lbl'Unds-GT-Eqls'Int'Unds'.yaml
Lblproject'Coln'TypedArg	Lblproject'Coln'TypedArg.yaml
LblisCallSixOp	LblisCallSixOp.yaml
LblinitLocalMemCell	LblinitLocalMemCell.yaml
Lblproject'Coln'AcctIDCellOpt	Lblproject'Coln'AcctIDCellOpt.yaml
LblisPcCell	LblisPcCell.yaml
Lblproject'Coln'EventArg	Lblproject'Coln'EventArg.yaml
LblisMessageCellFragment	LblisMessageCellFragment.yaml
LblisS2KlibZModforgeZSubstdZModsrcZModVmSafeContract	LblisS2KlibZModforgeZSubstdZModsrcZModVmSafeContract.yaml
LblisS2KscriptZModCounterScriptContract	LblisS2KscriptZModCounterScriptContract.yaml
Lbl'Unds'dividesInt'UndsUnds'INT-COMMON'Unds'Bool'Unds'Int'Unds'Int	Lbl'Unds'dividesInt'UndsUnds'INT-COMMON'Unds'Bool'Unds'Int'Unds'Int.yaml
LblisLengthPrefixType	LblisLengthPrefixType.yaml
Lbl'Hash'lenOfHeads'LParUndsRParUnds'EVM-ABI'Unds'Int'Unds'TypedArgs	Lbl'Hash'lenOfHeads'LParUndsRParUnds'EVM-ABI'Unds'Int'Unds'TypedArgs.yaml
LblisExpectEmitCellOpt	LblisExpectEmitCellOpt.yaml
LblinitAddressSetCell	LblinitAddressSetCell.yaml
Lbl'UndsLSqBUndsRSqBUnds'EVM-TYPES'Unds'Int'Unds'WordStack'Unds'Int	Lbl'UndsLSqBUndsRSqBUnds'EVM-TYPES'Unds'Int'Unds'WordStack'Unds'Int.yaml
Lbl'Hash'modexp2'LParUndsCommUndsCommUndsCommUndsRParUnds'EVM'Unds'Bytes'Unds'Int'Unds'Int'Unds'Int'Unds'Bytes	Lbl'Hash'modexp2'LParUndsCommUndsCommUndsCommUndsRParUnds'EVM'Unds'Bytes'Unds'Int'Unds'Int'Unds'Int'Unds'Bytes.yaml
LblinitEthereumCell	LblinitEthereumCell.yaml
Lblproject'Coln'LengthPrefixType	Lblproject'Coln'LengthPrefixType.yaml
LblinitCallStackCell	LblinitCallStackCell.yaml
Lblproject'Coln'SubstateCellFragment	Lblproject'Coln'SubstateCellFragment.yaml
Lbl'Hash'asWord'LParUndsRParUnds'EVM-TYPES'Unds'Int'Unds'Bytes	Lbl'Hash'asWord'LParUndsRParUnds'EVM-TYPES'Unds'Int'Unds'Bytes.yaml
Lblproject'Coln'TxChainIDCell	Lblproject'Coln'TxChainIDCell.yaml
Lbl'UndsPipe'Word'UndsUnds'EVM-TYPES'Unds'Int'Unds'Int'Unds'Int	Lbl'UndsPipe'Word'UndsUnds'EVM-TYPES'Unds'Int'Unds'Int'Unds'Int.yaml
LblinitTimestampCell	LblinitTimestampCell.yaml
Lbl'UndsPipe'Set'UndsUnds'SET'Unds'Set'Unds'Set'Unds'Set	Lbl'UndsPipe'Set'UndsUnds'SET'Unds'Set'Unds'Set'Unds'Set.yaml
LblisCallDataCellOpt	LblisCallDataCellOpt.yaml
LblisS2KlibZModkontrolZSubcheatcodesZModsrcZModKontrolCheatsBaseMethod	LblisS2KlibZModkontrolZSubcheatcodesZModsrcZModKontrolCheatsBaseMethod.yaml
Lbl'Hash'rlpEncodeBytes'LParUndsRParUnds'SERIALIZATION'Unds'Bytes'Unds'Bytes	Lbl'Hash'rlpEncodeBytes'LParUndsRParUnds'SERIALIZATION'Unds'Bytes'Unds'Bytes.yaml
Lblproject'Coln'NullStackOp	Lblproject'Coln'NullStackOp.yaml
Lblproject'Coln'OutputCell	Lblproject'Coln'OutputCell.yaml
LblinitTxPendingCell	LblinitTxPendingCell.yaml
LblisJumpDestsCellOpt	LblisJumpDestsCellOpt.yaml
Lblproject'Coln'S2KlibZModforgeZSubstdZModsrcZModmocksZModMockERC20Method	Lblproject'Coln'S2KlibZModforgeZSubstdZModsrcZModmocksZModMockERC20Method.yaml
Lblproject'Coln'SubstateCellOpt	Lblproject'Coln'SubstateCellOpt.yaml
Lbl'Unds-LT-Eqls'Map'UndsUnds'MAP'Unds'Bool'Unds'Map'Unds'Map	Lbl'Unds-LT-Eqls'Map'UndsUnds'MAP'Unds'Bool'Unds'Map'Unds'Map.yaml
Lblproject'Coln'PcCell	Lblproject'Coln'PcCell.yaml
Lblproject'Coln'TxPendingCell	Lblproject'Coln'TxPendingCell.yaml
Lblproject'Coln'ExitCodeCell	Lblproject'Coln'ExitCodeCell.yaml
Lblproject'Coln'S2KlibZModforgeZSubstdZModlibZModdsZSubtestZModsrcZModDSTestContract	Lblproject'Coln'S2KlibZModforgeZSubstdZModlibZModdsZSubtestZModsrcZModDSTestContract.yaml
Lblproject'Coln'TxOrderCell	Lblproject'Coln'TxOrderCell.yaml
LblgetExitCode	LblgetExitCode.yaml
LblisLogsBloomCellOpt	LblisLogsBloomCellOpt.yaml
